ChkRef,Debit,Credit,Balance,Date,Description
,23.62,,0.00,2021-12-02,JERSEY MIKE'S 27 PARK RIDGE IL (PENDING)
,,100.00,1972.64,2021-12-02,INTERNET TFR FRM CHK XXXX
,5.76,,1872.64,2021-12-02,DISCOVER E-PAYMENT 211201 WEB
,30.00,,1878.40,2021-12-02,BETTERMENT SEC TRANSFER 211201 WEB
,8.37,,1908.40,2021-12-02,MCDONALD'S F83 POS HARWOOD HEIGH IL US 030172
,6.06,,1916.77,2021-12-01,MCDONALD'S F6771 POS CHICAGO IL US 086933
,100.00,,1922.83,2021-12-01,INTERNET TFR TO CHK XXXX
,30.00,,2022.83,2021-11-30,ZEL*JULIAN GONZA POS Visa Direct AZ US 350752
,45.41,,2052.83,2021-11-30,OFFSET BBQ* OFFS POS HTTPSWWW.OFFS IL US 022289
,13.84,,2098.24,2021-11-30,RAISING CANE'S # POS HARWOOD HEIGH IL US 050164
,5.39,,2112.08,2021-11-30,McDonalds 83 POS 170-8867868 IL US 009585
,,500.00,2117.47,2021-11-30,INTERNET TFR FRM CHK XXXX
,,621.69,1617.47,2021-11-30,NETWORK MECHANTS DIRECT DEP 211130 PPD
,,42.64,995.78,2021-11-30,INSTANT PAYROLL 211130 PPD
,23.14,,953.14,2021-11-29,AMAZON.COM*JL6T6 POS SEATTLE WA US 006930
,12.31,,976.28,2021-11-29,MCDONALD'S M7882 POS SKOKIE IL US 078264
,14.58,,988.59,2021-11-29,OUTBACK 1420 POS SKOKIE IL US 048963
,500.00,,1003.17,2021-11-29,INTERNET TFR TO CHK XXXX
,4.41,,1503.17,2021-11-27,MCDONALD'S F83 POS HARWOOD HEIGH IL US 023029
,17.95,,1507.58,2021-11-26,UBER TRIP POS HELP.UBER.COM CA US 024303
,3.29,,1525.53,2021-11-26,UBER TRIP POS HELP.UBER.COM CA US 046734
,28.38,,1528.82,2021-11-26,MCDONALD'S F83 POS HARWOOD HTS IL US 497620
,5.76,,1557.20,2021-11-26,STARBUCKS 59748 POS NASHVILLE TN US 039949
,24.04,,1562.96,2021-11-24,SQ *RHINO BOOKSE POS NASHVILLE TN US 312822
,21.96,,1587.00,2021-11-24,UBER TRIP POS HELP.UBER.COM CA US 095175
,51.00,,1608.96,2021-11-23,CASH APP*MICHAEL POS XXXX CA US 008289
,4.41,,1659.96,2021-11-23,MCDONALD'S F83 POS HARWOOD HEIGH IL US 088700
,,56.59,1664.37,2021-11-23,INSTANT PAYROLL 211123 PPD
,30.24,,1607.78,2021-11-22,DISCOVER E-PAYMENT 211121 WEB
,30.67,,1638.02,2021-11-22,LAKSHAMI CORP. POS HARWOOD HEIGH IL US 968853
,22.99,,1668.69,2021-11-22,OUTBACK 1420 POS SKOKIE IL US 086846
,18.92,,1691.68,2021-11-19,MCDONALD'S F83 POS HARWOOD HTS IL US 614086
,4.43,,1710.60,2021-11-19,MCDONALD'S F2367 POS CHICAGO IL US 060295
,23.06,,1715.03,2021-11-17,PLANET FIT CLUB FEES PPD
,500.00,,1738.09,2021-11-17,CASH APP*MICHAEL POS XXXX CA US 056712
,14.01,,2238.09,2021-11-17,CHIPOTLE 1244 POS CHICAGO IL US 000060
,1000.00,,2252.10,2021-11-16,WITHDRAWAL FOSTER OFFICE
,,1500.00,3252.10,2021-11-16,Square Inc * Cash App 211116 CCD TXXXX16
,,51.57,1752.10,2021-11-16,INSTANT PAYROLL 211116 PPD
,51.34,,1700.53,2021-11-15,AMAZON.COM*HU30M POS SEATTLE WA US 000003
,14.99,,1751.87,2021-11-15,"Name.com, Inc POS 720-2492374 CO US 087585"
,13.46,,1766.86,2021-11-15,OUTBACK 1420 POS SKOKIE IL US 018384
,,722.40,1780.32,2021-11-15,NETWORK MECHANTS DIRECT DEP 211115 PPD
,,701.31,1057.92,2021-11-15,BETTERMENT SEC TRANSFER 211114 PPD
,,201.48,356.61,2021-11-15,BETTERMENT SEC TRANSFER 211114 PPD
,2.21,,155.13,2021-11-13,MCDONALD'S F83 POS HARWOOD HEIGH IL US 090885
,40.02,,157.34,2021-11-12,EXXONMOBIL 48 POS CHICAGO IL US 088154
,7.93,,197.36,2021-11-12,MCDONALD'S F83 POS HARWOOD HEIGH IL US 064806
,100.00,,205.29,2021-11-10,BETTERMENT SEC TRANSFER 211109 WEB
,11.60,,305.29,2021-11-10,COLECTIVO COFFEE POS CHICAGO IL US 019963
,4.40,,316.89,2021-11-10,MCDONALD'S F83 POS HARWOOD HEIGH IL US 032848
,0.30,,321.29,2021-11-09,eBay IncZ9T8DFGK PAYMENTS 211109 WEB
,4.41,,321.59,2021-11-09,MCDONALD'S F83 POS HARWOOD HEIGH IL US 027799
,24.43,,326.00,2021-11-05,BEST SUBMARINE # POS CHICAGO IL US 010833
,11.23,,350.43,2021-11-05,CHIPOTLE 0089 POS SKOKIE IL US 000266
,15.98,,361.66,2021-11-04,DISCOVER E-PAYMENT 211103 WEB
,11.43,,377.64,2021-11-04,MCDONALD'S F83 POS HARWOOD HEIGH IL US 037311
,24.96,,389.07,2021-11-03,MCDONALD'S F83 POS HARWOOD HEIGH IL US 032444
,,68.51,414.03,2021-11-02,INSTANT PAYROLL 211102 PPD
,39.00,,345.52,2021-11-01,PLANET FIT CLUB FEES PPD
,19.62,,384.52,2021-11-01,OUTBACK 1420 POS SKOKIE IL US 038341
,2.21,,404.14,2021-11-01,MCDONALD'S F83 POS HARWOOD HEIGH IL US 014167
,,308.64,406.35,2021-10-29,NETWORK MECHANTS DIRECT DEP 211029 PPD
,22.03,,97.71,2021-10-28,PET SUPPLIES PLU POS CHICAGO IL US 002770
,27.23,,119.74,2021-10-27,AMAZON.COM*HO4FC POS SEATTLE WA US 000000
,6.70,,146.97,2021-10-27,MCDONALD'S F83 POS HARWOOD HEIGH IL US 040848
,,58.83,153.67,2021-10-26,INSTANT PAYROLL 211026 PPD
,55.00,,94.84,2021-10-25,ZEL*JULIAN GONZA POS Visa Direct AZ US 967673
,2.21,,149.84,2021-10-25,MCDONALD'S F83 POS HARWOOD HEIGH IL US 074654
,,147.75,152.05,2021-10-25,Michael Dougherty POS Visa Direct CA US 818455
,39.61,,,2021-10-22,SHELL OIL 574440 POS CHICAGO IL US 003996 ****
,27.67,,,2021-10-20,COZY CORNE* COZY POS STRIPE.COM IL US 007275 ****
,,144.39,,2021-10-19,INSTANT PAYROLL 211019 PPD
,,215.63,,2021-10-19,Michael Dougherty POS Visa Direct CA US 837832 ****
,1900.00,,,2021-10-19,WITHDRAWAL NORWOOD OFFICE
,12.94,,,2021-10-19,JIMMY JOHNS - 56 POS CHICAGO IL US 058554 ****
,6.82,,,2021-10-19,MCDONALD'S F83 POS HARWOOD HEIGH IL US 041083 ****
,17.18,,,2021-10-19,RAISING CANE'S # POS HARWOOD HEIGH IL US 050427 ****
,4.17,,,2021-10-18,MCDONALD'S F83 POS HARWOOD HEIGH IL US 032437 ****
,13.08,,,2021-10-18,MCDONALD'S F83 POS HARWOOD HEIGH IL US 032655 ****
,14.30,,,2021-10-18,OUTBACK 1420 POS SKOKIE IL US 035641 ****
,98.00,,,2021-10-16,OLD TOWN SCHOOL POS 773-7286000 IL US 017898 ****
,6.69,,,2021-10-16,MCDONALD'S F83 POS HARWOOD HEIGH IL US 011795 ****
,7.29,,,2021-10-16,OUTBACK 1420 POS SKOKIE IL US 039248 ****
,,33.00,,2021-10-15,INTERNET TFR FRM CHK XXXX
,2.21,,,2021-10-15,MCDONALD'S F83 POS HARWOOD HEIGH IL US 067623 ****
,20.47,,,2021-10-14,OUTBACK 1420 POS SKOKIE IL US 009311 ****
,,82.77,,2021-10-13,INSTANT PAYROLL 211013 PPD
,,250.00,,2021-10-13,CCCGO REFUND 211012 PPD
,6.82,,,2021-10-13,MCDONALD'S F83 POS HARWOOD HEIGH IL US 040370 ****
,33.06,,,2021-10-13,CVS/PHARMACY #03 POS Chicago IL US 177227 ****
,8.04,,,2021-10-12,MCDONALD'S F83 POS HARWOOD HEIGH IL US 039499 ****
,500.00,,,2021-10-12,BETTERMENT SEC TRANSFER 211011 WEB
,500.00,,,2021-10-12,BETTERMENT SEC TRANSFER 211011 WEB
,40.06,,,2021-10-11,TOM - JOE POS CHICAGO IL US 271868 ****
,8.58,,,2021-10-11,SQ *WESTON'S COF POS Chicago IL US 051198 ****
,8.98,,,2021-10-11,MCDONALD'S M7882 POS SKOKIE IL US 059180 ****
,5.37,,,2021-10-09,MCDONALD'S M7882 POS SKOKIE IL US 072623 ****
,4.40,,,2021-10-09,MCDONALD'S F83 POS HARWOOD HEIGH IL US 002507 ****
,,750.00,,2021-10-08,CCCGO REFUND 211007 PPD
,16.28,,,2021-10-08,MCDONALD'S F83 POS HARWOOD HEIGH IL US 062464 ****
,,1500.00,,2021-10-07,VENMO CASHOUT 211006 PPD
,2.21,,,2021-10-06,MCDONALD'S F83 POS HARWOOD HEIGH IL US 045943 ****
,5.38,,,2021-10-06,MCDONALD'S F83 POS HARWOOD HEIGH IL US 046185 ****
,45.00,,,2021-10-06,ZEL*JULIAN GONZA POS Visa Direct AZ US 468940 ****
,,74.11,,2021-10-05,INSTANT PAYROLL 211005 PPD
,2.38,,,2021-10-05,MCDONALD'S F1011 POS TOLEDO OH US 039523 ****
,4.00,,,2021-10-05,TST* TREE CITY C POS KENT OH US 067560 ****
,2.21,,,2021-09-24,MCDONALD'S F83 POS HARWOOD HEIGH IL US 092273 ****
,1.00,,,2021-09-24,CASH APP*MICHAEL POS XXXX CA US 040153 ****
,,89.26,,2021-09-23,Michael Dougherty POS Visa Direct CA US 937782 ****
,15.70,,,2021-09-23,OUTBACK 1420 POS SKOKIE IL US 044729 ****
,19.96,,,2021-09-23,6211 PF ILLINOIS POS CHICAGO IL US 038391 ****
,12.77,,,2021-09-23,MCDONALD'S F83 POS HARWOOD HEIGH IL US 074727 ****
,100.00,,,2021-09-23,BETTERMENT SEC TRANSFER 210922 WEB
,5.50,,,2021-09-22,LITTLE MELS HOTD POS CHICAGO IL US 090005 ****
,2.21,,,2021-09-22,MCDONALD'S F83 POS HARWOOD HEIGH IL US 074701 ****
,8.62,,,2021-09-21,JIMMY JOHNS - 29 POS NILES IL US 062664 ****
,14.02,,,2021-09-21,OUTBACK 1420 POS SKOKIE IL US 063246 ****
,5.00,,,2021-09-21,DARK MATTER COFF POS CHICAGO IL US 027798 ****
,,113.04,,2021-09-20,Financial Instant POS Alpharetta GA US 091906 ****
,13.00,,,2021-09-18,SQ *WE WILL WOK POS CHILLICOTHE IL US 191706 ****
,7.80,,,2021-09-18,SQ *HOMETEAM PIZ POS Chicago IL US 011803 ****
,10.22,,,2021-09-18,DUNKIN #342335 Q POS CHICAGO IL US 007374 ****
,5.60,,,2021-09-17,OUTBACK 1420 POS SKOKIE IL US 013503 ****
,3.19,,,2021-09-17,CVS/PHARMACY #03 POS Chicago IL US 170804 ****
,8.98,,,2021-09-17,MCDONALD'S M7882 POS SKOKIE IL US 010201 ****
,152.91,,,2021-09-16,EB RIOT FEST 202 POS 801-413-7200 CA US 023412 ****
,5.83,,,2021-09-16,DUNKIN #350881 Q POS CHICAGO IL US 006114 ****
,20.00,,,2021-09-16,CASH APP*MICHAEL POS XXXX CA US 020082 ****
,4.98,,,2021-09-16,SQ *ATMOS COFFEE POS CHICAGO IL US 046338 ****
,,85.00,,2021-09-15,FIRST ASCENT CLI POS CHICAGO IL US 046168 ****
,,137.51,,2021-09-15,Michael Dougherty POS Visa Direct CA US 813220 ****
,10.09,,,2021-09-15,OUTBACK 1420 POS SKOKIE IL US 041700 ****
,17.72,,,2021-09-15,SUSHI TAKU POS CHICAGO IL US 048486 ****
,100.00,,,2021-09-15,BETTERMENT SEC TRANSFER 210914 WEB
,60.00,,,2021-09-15,BETTERMENT SEC TRANSFER 210914 WEB
,,246.25,,2021-09-14,Michael Dougherty POS Visa Direct CA US 949967 ****
,9.53,,,2021-09-14,OUTBACK 1420 POS SKOKIE IL US 030987 ****
,6.59,,,2021-09-14,SQ *WESTON'S COF POS Chicago IL US 001863 ****
,7.68,,,2021-09-14,SQ *LET'S CHANGE POS Chicago IL US 074837 ****
,25.80,,,2021-09-13,OUTBACK 1420 POS SKOKIE IL US 004463 ****
,45.00,,,2021-09-13,ZEL*JULIAN GONZA POS Visa Direct AZ US 342677 ****
,35.00,,,2021-09-13,EXXONMOBIL 48 POS CHICAGO IL US 020078 ****
,5.94,,,2021-09-11,Amazon.com*2G0XO POS Amzn.com/bill WA US 011858 ****
,18.78,,,2021-09-09,JIMMY JOHNS - 56 POS CHICAGO IL US 049363 ****
,17.39,,,2021-09-09,OUTBACK 1420 POS SKOKIE IL US 069556 ****
,,49.47,,2021-09-08,INSTANT PAYROLL 210908 PPD
,8.05,,,2021-09-08,CHINA FAST WOK POS CHICAGO IL US 047035 ****
,,137.44,,2021-09-07,INSTANT PAYROLL 210907 PPD
,14.02,,,2021-09-07,OUTBACK 1420 POS SKOKIE IL US 003632 ****
,17.67,,,2021-09-07,OUTBACK 1420 POS SKOKIE IL US 092218 ****
,6.37,,,2021-09-07,MCDONALD'S F83 POS HARWOOD HEIGH IL US 066567 ****
,4.15,,,2021-09-04,SQ *WESTON'S COF POS Chicago IL US 099659 ****
,5.74,,,2021-09-04,MCDONALD'S F866 POS CHICAGO IL US 061285 ****
,7.27,,,2021-09-03,MCDONALD'S F83 POS HARWOOD HEIGH IL US 097991 ****
,4.42,,,2021-09-03,MCDONALD'S F2930 POS CHICAGO IL US 026428 ****
,85.00,,,2021-09-02,FIRST ASCENT CLI POS CHICAGO IL US 020293 ****
,10.93,,,2021-09-02,OUTBACK 1420 POS SKOKIE IL US 053245 ****
,19.63,,,2021-09-01,OUTBACK 1420 POS SKOKIE IL US 000569 ****
,35.19,,,2021-09-01,BP#1700756N CENT POS CHICAGO IL US 078540 ****
,,44.79,,2021-08-31,INSTANT PAYROLL 210831 PPD
,11.06,,,2021-08-31,MCDONALD'S F6298 POS CHICAGO IL US 072157 ****
,,100.00,,2021-08-31,Square Inc * Cash App 210831 CCD TXXXX34
,5.48,,,2021-08-31,SQ *LET'S CHANGE POS Chicago IL US 044746 ****
,12.09,,,2021-08-31,Amazon.com*250TZ POS Amzn.com/bill WA US 056972 ****
,,115.46,,2021-08-30,Michael Dougherty POS Visa Direct CA US 966349 ****
,19.66,,,2021-08-30,SQ *WESTON'S COF POS CHICAGO IL US 342514 ****
,,15.00,,2021-08-27,PAYPAL *SPP POS 402-935-7733 CA US 020668 ****
,2.76,,,2021-08-27,NORWOOD LIFE SOC POS CHICAGO IL US 087654 ****
,2.20,,,2021-08-26,MCDONALD'S F4417 POS CHICAGO IL US 039686 ****
,15.00,,,2021-08-26,PAYPAL *SPP POS 402-935-7733 CA US 076817 ****
,15.00,,,2021-08-26,PAYPAL *SPP POS 402-935-7733 CA US 094639 ****
,4.17,,,2021-08-26,MCDONALD'S F83 POS HARWOOD HEIGH IL US 022749 ****
,,40.00,,2021-08-25,Financial Instant POS Alpharetta GA US 250498 ****
,30.00,,,2021-08-25,LAKSHAMI CORP. POS HARWOOD HEIGH IL US 483944 ****
,,49.71,,2021-08-23,Michael Dougherty POS Visa Direct CA US 816561 ****
,6.69,,,2021-08-23,MCDONALD'S F83 POS HARWOOD HEIGH IL US 046680 ****
,11.21,,,2021-08-23,OUTBACK 1420 POS SKOKIE IL US 000589 ****
,20.45,,,2021-08-23,MCDONALD'S F83 POS HARWOOD HEIGH IL US 052729 ****
,25.00,,,2021-08-23,ZEL*JULIAN GONZA POS Visa Direct AZ US 245998 ****
,5.49,,,2021-08-21,TST* NOBAKED COO POS NASHVILLE TN US 080291 ****
,6.56,,,2021-08-20,SQ *HEART OF NAS POS Nashville TN US 073870 ****
,,38.44,,2021-08-19,INSTANT PAYROLL 210819 PPD
,21.85,,,2021-08-19,SQ *RHINO BOOKSE POS NASHVILLE TN US 381659 ****
,4.31,,,2021-08-18,MCDONALD'S F866 POS CHICAGO IL US 027968 ****
,10.75,,,2021-08-18,eBay IncUKC9XHSE PAYMENTS 210818 WEB
,,10.45,,2021-08-17,EBAY EDI PYMNTS CCD TXXXXXXT
,,87.32,,2021-08-17,Michael Dougherty POS Visa Direct CA US 829359 ****
,160.00,,,2021-08-17,WITHDRAWAL FOSTER OFFICE
,,100.00,,2021-08-16,INTERNET TFR FRM CHK XXXX
,30.64,,,2021-08-16,MY MART POS CHICAGO IL US 795571 ****
,15.14,,,2021-08-16,OUTBACK 1420 POS SKOKIE IL US 001262 ****
,5.60,,,2021-08-14,OUTBACK 1420 POS SKOKIE IL US 000024 ****
,5.74,,,2021-08-13,MCDONALD'S F866 POS CHICAGO IL US 068504 ****
,10.63,,,2021-08-13,POTBELLY # 181 POS 847-692-6699 IL US 062426 ****
,15.30,,,2021-08-13,OBERWEIS DAIRY POS PARK RIDGE IL US 015921 ****
,,15.00,,2021-08-12,INTERNET TFR FRM CHK XXXX
,8.57,,,2021-08-12,MCDONALD'S F4417 POS CHICAGO IL US 069079 ****
,3.88,,,2021-08-12,CVS/PHARMACY #03 POS Chicago IL US 041353 ****
,45.00,,,2021-08-11,ZEL*JULIAN GONZA POS Visa Direct AZ US 825123 ****
,,14.75,,2021-08-11,Dougherty Mike POS New York City NY US 557180 ****
,,103.17,,2021-08-11,Michael Dougherty POS Visa Direct CA US 900831 ****
,12.54,,,2021-08-11,MCDONALD'S F83 POS HARWOOD HEIGH IL US 002524 ****
,10.22,,,2021-08-11,MCDONALD'S F83 POS HARWOOD HEIGH IL US 002880 ****
,20.00,,,2021-08-10,CASH APP*MICHAEL POS XXXX CA US 032570 ****
,,59.38,,2021-08-09,Financial Instant POS Alpharetta GA US 090155 ****
,18.78,,,2021-08-09,OUTBACK 1420 POS SKOKIE IL US 035586 ****
,4.41,,,2021-08-09,WALGREENS STORE POS CHICAGO IL US 158516 ****
,12.99,,,2021-08-09,MCDONALD'S F83 POS HARWOOD HEIGH IL US 038367 ****
,,30.00,,2021-08-07,Financial Instant POS Alpharetta GA US 807028 ****
,,15.00,,2021-08-07,INTERNET TFR FRM CHK XXXX
,25.26,,,2021-08-07,MY MART POS CHICAGO IL US 393986 ****
,,25.00,,2021-08-06,VENMO CASHOUT 210805 PPD
,8.04,,,2021-08-06,MCDONALD'S F83 POS HARWOOD HEIGH IL US 029405 ****
,4.96,,,2021-08-06,MCDONALD'S F83 POS HARWOOD HEIGH IL US 029844 ****
,,10.00,,2021-08-05,INTERNET TFR FRM CHK XXXX
,42.09,,,2021-08-05,CAVIAR*HONEY BUT POS WWW.DOORDASH. CA US 068474 ****
,,25.00,,2021-08-04,INTERNET TFR FRM CHK XXXX
,24.62,,,2021-08-04,JERSEY MIKES 270 POS PARK RIDGE IL US 000018 ****
,,43.11,,2021-08-03,INSTANT PAYROLL 210803 PPD
,,35.00,,2021-08-02,INTERNET TFR FRM CHK XXXX
,,20.00,,2021-08-02,VENMO CASHOUT 210801 PPD
,,22.00,,2021-08-02,INTERNET TFR FRM CHK XXXX
,42.86,,,2021-08-02,GRUBHUBRUKSUSHIT POS GRUBHUB.COM NY US 052979 ****
,15.00,,,2021-08-02,FASTWAY MART POS CHICAGO IL US 462684 ****
,85.00,,,2021-08-02,FIRST ASCENT CLI POS CHICAGO IL US 035361 ****
,6.62,,,2021-08-02,MCDONALD'S F83 POS HARWOOD HEIGH IL US 074120 ****
,30.00,,,2021-08-02,COINBASE INC. XXXX 210731 WEB
,7.74,,,2021-07-31,MCDONALD'S F866 POS CHICAGO IL US 072346 ****
,6.18,,,2021-07-30,MCDONALD'S F4417 POS CHICAGO IL US 040832 ****
,5.06,,,2021-07-29,MCDONALD'S F83 POS HARWOOD HEIGH IL US 022168 ****
,18.15,,,2021-07-29,MCDONALD'S F83 POS HARWOOD HTS IL US 794246 ****
,13.46,,,2021-07-29,OUTBACK 1420 POS SKOKIE IL US 051935 ****
,,200.00,,2021-07-27,BETTERMENT SEC TRANSFER 210726 PPD
,50.00,,,2021-07-27,INTERNET TFR TO CHK XXXX
,6.37,,,2021-07-26,MCDONALD'S F83 POS HARWOOD HEIGH IL US 046048 ****
,,15.00,,2021-07-24,INTERNET TFR FRM CHK XXXX
,,14.41,,2021-07-24,Michael Dougherty POS Visa Direct CA US 867705 ****
,20.14,,,2021-07-24,LAKSHAMI CORP. POS HARWOOD HEIGH IL US 331211 ****
,6.69,,,2021-07-23,MCDONALD'S F83 POS HARWOOD HEIGH IL US 040564 ****
,14.08,,,2021-07-23,MCDONALD'S F83 POS HARWOOD HEIGH IL US 040672 ****
,,9.75,,2021-07-22,Michael Dougherty POS Visa Direct CA US 478739 ****
,,25.00,,2021-07-22,INTERNET TFR FRM CHK XXXX
,3.85,,,2021-07-22,MCDONALD'S F866 POS CHICAGO IL US 032657 ****
,6.70,,,2021-07-22,DD/BR #304935 Q3 POS CHICAGO IL US 093988 ****
,30.00,,,2021-07-22,ZEL*JULIAN GONZA POS Visa Direct AZ US 550795 ****
,29.40,,,2021-07-22,CVS/PHARMACY #03 POS Chicago IL US 031818 ****
,,40.79,,2021-07-21,Michael Dougherty POS Visa Direct CA US 991468 ****
,,84.15,,2021-07-21,Dougherty Mike POS New York City NY US 668412 ****
,60.00,,,2021-07-21,6336 N MILWAUKEE AV ATM CHICAGO IL US 009708 ****
,25.00,,,2021-07-21,CASH APP*MICHAEL POS XXXX CA US 072428 ****
,6.07,,,2021-07-17,MCDONALD'S F866 POS CHICAGO IL US 023004 ****
,,14.75,,2021-07-16,Dougherty Mike POS New York City NY US 165986 ****
,11.30,,,2021-07-16,MCDONALD'S F83 POS HARWOOD HEIGH IL US 047499 ****
,,20.00,,2021-07-13,INTERNET TFR FRM CHK XXXX
,7.27,,,2021-07-13,MCDONALD'S F83 POS HARWOOD HEIGH IL US 003582 ****
,,20.00,,2021-07-12,INTERNET TFR FRM CHK XXXX
,14.96,,,2021-07-12,MCDONALD'S F912 POS CHICAGO IL US 094572 ****
,18.00,,,2021-07-12,CASH APP*MICHAEL POS XXXX CA US 095216 ****
,5.85,,,2021-07-12,MCDONALD'S F866 POS CHICAGO IL US 062042 ****
,7.09,,,2021-07-12,LAKSHAMI CORP. POS HARWOOD HEIGH IL US 977297 ****
,3.51,,,2021-07-10,FIRST ASCENT CLI POS CHICAGO IL US 002798 ****
,,30.00,,2021-07-09,INTERNET TFR FRM CHK XXXX
,71.00,,,2021-07-07,FIRST ASCENT CLI POS CHICAGO IL US 093495 ****
,,8.75,,2021-07-06,Michael Dougherty POS Visa Direct CA US 363314 ****
,,14.75,,2021-07-06,Dougherty Mike POS New York City NY US 254211 ****
,,20.00,,2021-07-06,INTERNET TFR FRM CHK XXXX
,30.00,,,2021-07-06,ZEL*JULIAN GONZA POS Visa Direct AZ US 184762 ****
,7.38,,,2021-07-06,MCDONALD'S F83 POS HARWOOD HEIGH IL US 044744 ****
,18.03,,,2021-07-06,MCDONALD'S F83 POS HARWOOD HTS IL US 905486 ****
,9.01,,,2021-07-06,MCDONALD'S F83 POS HARWOOD HEIGH IL US 077346 ****
,2.66,,,2021-07-06,838 BOWLERO 800 POS NILES IL US 073590 ****
,18.10,,,2021-07-06,838 BOWLERO 800 POS NILES IL US 073582 ****
,20.23,,,2021-07-06,LAKSHAMI CORP. POS HARWOOD HEIGH IL US 085999 ****
,100.00,,,2021-07-06,BETTERMENT SEC TRANSFER 210705 WEB
,12.00,,,2021-07-06,BETTERMENT SEC TRANSFER 210705 WEB
,25.66,,,2021-07-03,CULVERS HARWOOD POS HARWOOD HEIGH IL US 083392 ****
,7.27,,,2021-07-03,MCDONALD'S F83 POS HARWOOD HEIGH IL US 099013 ****
,,26.00,,2021-07-02,INTERNET TFR FRM CHK XXXX
,36.85,,,2021-07-01,838 BOWLERO 800 POS NILES IL US 035442 ****
,22.78,,,2021-07-01,JIMMY JOHNS - 56 POS 773-625-2551 IL US 088237 ****
,10.00,,,2021-06-30,CASH APP*MICHAEL POS XXXX CA US 018804 ****
,8.52,,,2021-06-29,DD/BR #308162 Q3 POS RIVER GROVE IL US 041459 ****
,6.41,,,2021-06-29,DD/BR #308162 Q3 POS RIVER GROVE IL US 041458 ****
,,50.00,,2021-06-28,DEPOSIT FOSTER OFFICE
,80.00,,,2021-06-28,WITHDRAWAL FOSTER OFFICE
,2.21,,,2021-06-28,MCDONALD'S F83 POS HARWOOD HEIGH IL US 037211 ****
,12.00,,,2021-06-28,CASH APP*MICHAEL POS XXXX CA US 087036 ****
,58.52,,,2021-06-28,THE HOME DEPOT # POS NILES IL US 002107 ****
,15.00,,,2021-06-28,VENMO PAYMENT 210625 WEB
,,19.34,,2021-06-24,Square Inc * Cash App 210624 CCD TXXXX38
,2.00,,,2021-06-24,CASH APP*MICHAEL POS XXXX CA US 077149 ****
,20.75,,,2021-06-24,THE HOME DEPOT # POS NILES IL US 001088 ****
,,57.73,,2021-06-23,INSTANT PAYROLL 210623 PPD
,51.15,,,2021-06-23,PHIL'S PIZZA D'O POS 773-763-2285 IL US 020030 ****
,6.86,,,2021-06-23,MCDONALD'S F866 POS CHICAGO IL US 086043 ****
,,50.00,,2021-06-22,INTERNET TFR FRM CHK XXXX
,30.14,,,2021-06-22,7-ELEVEN 38544 POS CHICAGO IL US 515500 ****
,45.83,,,2021-06-22,AMAZON.COM*219SP POS SEATTLE WA US 407602 ****
,6.37,,,2021-06-22,MCDONALD'S F83 POS HARWOOD HEIGH IL US 003653 ****
,11.84,,,2021-06-18,DAIRY QUEEN PARK POS PARK RIDGE IL US 030111 ****
,2.21,,,2021-06-18,MCDONALD'S F83 POS HARWOOD HEIGH IL US 046123 ****
,20.91,,,2021-06-17,WALGREENS STORE POS CHICAGO IL US 253737 ****
,6.58,,,2021-06-17,JAYS FOOD & LIQU POS CHICAGO IL US 002856 ****
,,20.00,,2021-06-16,INTERNET TFR FRM CHK XXXX
,20.00,,,2021-06-16,CASH APP*MICHAEL POS XXXX CA US 016287 ****
,14.85,,,2021-06-16,MCDONALD'S F83 POS HARWOOD HEIGH IL US 009787 ****
,17.95,,,2021-06-16,POTBELLY #181 POS PARK RIDGE IL US 086105 ****
,,83.54,,2021-06-15,INSTANT PAYROLL 210615 PPD
,10.00,,,2021-06-14,VENMO PAYMENT 210612 WEB
,2.21,,,2021-06-12,MCDONALD'S F83 POS HARWOOD HEIGH IL US 067999 ****
,2.21,,,2021-06-12,MCDONALD'S F83 POS HARWOOD HEIGH IL US 068213 ****
,5.00,,,2021-06-12,CASH APP*MICHAEL POS XXXX CA US 016155 ****
,9.34,,,2021-06-11,MCDONALD'S F83 POS HARWOOD HEIGH IL US 034504 ****
,,500.00,,2021-06-09,BETTERMENT SEC TRANSFER 210608 PPD
,12.12,,,2021-06-09,MCDONALD'S F83 POS HARWOOD HEIGH IL US 096328 ****
,20.00,,,2021-06-08,CASH APP*MICHAEL POS XXXX CA US 065330 ****
,2.92,,,2021-06-08,STARBUCKS STORE POS HARWOOD HEIGH IL US 058978 ****
,3.93,,,2021-06-08,STARBUCKS STORE POS HARWOOD HEIGH IL US 059024 ****
,,10.00,,2021-06-07,INTERNET TFR FRM CHK XXXX
,,60.09,,2021-06-07,Financial Instant POS Alpharetta GA US 060706 ****
,94.01,,,2021-06-07,JERSEY MIKES 270 POS NILES IL US 000068 ****
,2.22,,,2021-06-07,MCDONALD'S F866 POS CHICAGO IL US 025546 ****
,10.27,,,2021-06-07,WENDYS #0981 POS CHICAGO IL US 143088 ****
,,111.08,,2021-06-05,Michael Dougherty POS Visa Direct CA US 360050 ****
,40.00,,,2021-06-04,BETTERMENT SEC TRANSFER 210603 WEB
,17.92,,,2021-06-03,JIMMY JOHNS - 56 POS CHICAGO IL US 004545 ****
,20.31,,,2021-06-03,SHELL SERVICE ST POS CHICAGO IL US 374653 ****
,,44.07,,2021-06-02,INSTANT PAYROLL 210602 PPD
,,15.00,,2021-06-01,INTERNET TFR FRM CHK XXXX
,,45.00,,2021-06-01,Financial Instant POS Alpharetta GA US 000086 ****
,,11.00,,2021-06-01,VENMO CASHOUT 210529 PPD
,43.40,,,2021-06-01,JEWEL OSCO 1296 POS CHICAGO IL US 373319 ****
,12.79,,,2021-06-01,Subway 2644 POS Chicago IL US 075873 ****
,9.41,,,2021-05-29,SUPERDAWG DRIVE POS 773-4787800 IL US 047574 ****
,4.73,,,2021-05-29,DUNKIN #350881 Q POS CHICAGO IL US 030624 ****
,,4.00,,2021-05-28,INTERNET TFR FRM CHK XXXX
,6.72,,,2021-05-28,MCDONALD'S F6298 POS CHICAGO IL US 046516 ****
,7.83,,,2021-05-28,MCDONALD'S F6298 POS CHICAGO IL US 046524 ****
,,20.00,,2021-05-27,INTERNET TFR FRM CHK XXXX
,4.18,,,2021-05-27,MCDONALD'S F83 POS HARWOOD HEIGH IL US 011979 ****
,8.82,,,2021-05-26,MCDONALD'S F83 POS HARWOOD HEIGH IL US 092119 ****
,25.00,,,2021-05-25,CASH APP*MICHAEL POS XXXX CA US 047028 ****
,12.70,,,2021-05-25,MCDONALD'S F866 POS CHICAGO IL US 061622 ****
,4.07,,,2021-05-25,MCDONALD'S F83 POS HARWOOD HEIGH IL US 087491 ****
,,25.00,,2021-05-24,INTERNET TFR FRM CHK XXXX
,,75.00,,2021-05-24,Financial Instant POS Alpharetta GA US 105240 ****
,3.20,,,2021-05-24,MCDONALD'S F866 POS CHICAGO IL US 078844 ****
,1.65,,,2021-05-24,NORWOOD LIFE SOC POS CHICAGO IL US 074624 ****
,20.23,,,2021-05-24,JMC FOOD MART POS CHICAGO IL US 658728 ****
,10.00,,,2021-05-24,BETTERMENT SEC TRANSFER 210523 WEB
,10.00,,,2021-05-24,BETTERMENT SEC TRANSFER 210523 WEB
,,5.00,,2021-05-22,INTERNET TFR FRM CHK XXXX
,2.63,,,2021-05-22,CASH APP*MICHAEL POS XXXX CA US 020287 ****
,,14.75,,2021-05-20,Michael Dougherty POS Visa Direct CA US 850101 ****
,6.15,,,2021-05-20,MCDONALD'S F83 POS HARWOOD HEIGH IL US 099945 ****
,,12.00,,2021-05-19,INTERNET TFR FRM CHK XXXX
,20.03,,,2021-05-19,EXXONMOBIL 97 POS HARWOOD HEIGH IL US 073838 ****
,6.71,,,2021-05-19,MCDONALD'S F83 POS HARWOOD HEIGH IL US 087209 ****
,,55.34,,2021-05-18,INSTANT PAYROLL 210518 PPD
,,20.00,,2021-05-18,INTERNET TFR FRM CHK XXXX
,1.13,,,2021-05-18,CVS/PHARMACY #03 POS Chicago IL US 177207 ****
,5.76,,,2021-05-18,JEWEL OSCO 1296 POS CHICAGO IL US 245746 ****
,35.75,,,2021-05-18,JEWEL OSCO 1296 POS CHICAGO IL US 491071 ****
,12.00,,,2021-05-18,CASH APP*MICHAEL POS XXXX CA US 034800 ****
,20.00,,,2021-05-18,CASH APP*MICHAEL POS XXXX CA US 066400 ****
,,15.00,,2021-05-17,INTERNET TFR FRM CHK XXXX
,,400.00,,2021-05-17,BETTERMENT SEC TRANSFER 210516 PPD
,,360.00,,2021-05-17,Coinbase.com ZP34JPNM PPD
,5.00,,,2021-05-17,CASH APP*MICHAEL POS XXXX CA US 002748 ****
,10.00,,,2021-05-17,CASH APP*MICHAEL POS XXXX CA US 026901 ****
,10.00,,,2021-05-17,CASH APP*MICHAEL POS XXXX CA US 092849 ****
,12.90,,,2021-05-17,OUTBACK 1420 POS SKOKIE IL US 072762 ****
,365.08,,,2021-05-17,CASH APP*MICHAEL POS XXXX CA US 063391 ****
,360.00,,,2021-05-17,Coinbase.com TT32H3CG WEB
,10.00,,,2021-05-17,VENMO PAYMENT 210515 WEB
,10.00,,,2021-05-17,BETTERMENT SEC TRANSFER 210516 WEB
,10.00,,,2021-05-17,BETTERMENT SEC TRANSFER 210516 WEB
,,24.62,,2021-05-13,Michael Dougherty POS Visa Direct CA US 448611 ****
,8.00,,,2021-05-13,VENMO PAYMENT 210512 WEB
,5.62,,,2021-05-12,DUNKIN #342335 Q POS CHICAGO IL US 018396 ****
,,10.00,,2021-05-11,INTERNET TFR FRM CHK XXXX
,4.64,,,2021-05-11,MCDONALD'S F866 POS CHICAGO IL US 051682 ****
,228.80,,,2021-05-11,ARCHIES PRECIOUS POS CHICAGO IL US 025142 ****
,50.00,,,2021-05-11,Coinbase.com HX5ACGCC WEB
,,166.74,,2021-05-10,Financial Instant POS Alpharetta GA US 105100 ****
,,110.06,,2021-05-10,Michael Dougherty POS Visa Direct CA US 981396 ****
,6.38,,,2021-05-10,CVS/PHARMACY #03 POS Chicago IL US 177609 ****
,10.00,,,2021-05-10,BETTERMENT SEC TRANSFER 210509 WEB
,10.00,,,2021-05-10,BETTERMENT SEC TRANSFER 210509 WEB
,3.41,,,2021-05-07,DUNKIN #342335 Q POS CHICAGO IL US 017294 ****
,3.13,,,2021-05-07,DUNKIN #342335 Q POS CHICAGO IL US 017296 ****
,3.64,,,2021-05-07,MY MART POS CHICAGO IL US 796519 ****
,,49.25,,2021-05-06,Michael Dougherty POS Visa Direct CA US 476189 ****
,3.00,,,2021-05-06,CASH APP*MICHAEL POS XXXX CA US 002613 ****
,5.00,,,2021-05-06,CASH APP*MICHAEL POS XXXX CA US 045361 ****
,50.00,,,2021-05-06,CASH APP*MICHAEL POS XXXX CA US 011079 ****
,5.00,,,2021-05-06,CASH APP*MICHAEL POS XXXX CA US 001398 ****
,20.01,,,2021-05-06,EXXONMOBIL 99 POS CHICAGO IL US 019246 ****
,2.98,,,2021-05-06,MY MART POS CHICAGO IL US 608398 ****
,,20.75,,2021-05-05,Dougherty Mike POS New York City NY US 646255 ****
,20.00,,,2021-05-05,VENMO PAYMENT 210504 WEB
,17.00,,,2021-05-05,VENMO PAYMENT 210504 WEB
,,91.72,,2021-05-04,INSTANT PAYROLL 210504 PPD
,20.00,,,2021-05-04,CASH APP*MICHAEL POS XXXX CA US 001056 ****
,,5.72,,2021-05-03,Michael Dougherty POS Visa Direct CA US 455942 ****
,,17.25,,2021-05-03,Dougherty Mike POS New York City NY US 316986 ****
,10.00,,,2021-05-03,CASH APP*MICHAEL POS XXXX CA US 054228 ****
,3.25,,,2021-05-03,CASH APP*MICHAEL POS XXXX CA US 025443 ****
,19.14,,,2021-05-03,MCDONALD'S F83 POS HARWOOD HEIGH IL US 068555 ****
,15.00,,,2021-05-03,CASH APP*MICHAEL POS XXXX CA US 018392 ****
,200.00,,,2021-05-03,BETTERMENT SEC TRANSFER 210502 WEB
,20.00,,,2021-05-03,BETTERMENT SEC TRANSFER 210502 WEB
,10.00,,,2021-05-03,BETTERMENT SEC TRANSFER 210502 WEB
,10.00,,,2021-05-03,BETTERMENT SEC TRANSFER 210502 WEB
,17.17,,,2021-05-01,PORTILLOS HOT DO POS HARWOOD HTS. IL US 000686 ****
,,191.50,,2021-04-28,INSTANT PAYROLL 210428 PPD
,19.00,,,2021-04-28,FIRST ASCENT CLI POS CHICAGO IL US 080569 ****
,200.00,,,2021-04-28,BETTERMENT SEC TRANSFER 210427 WEB
,,300.00,,2021-04-27,Square Inc * Cash App 210427 CCD TXXXX43
,10.00,,,2021-04-26,BETTERMENT SEC TRANSFER 210425 WEB
,10.00,,,2021-04-26,BETTERMENT SEC TRANSFER 210425 WEB
,,100.00,,2021-04-22,INTERNET TFR FRM CHK XXXX
,100.00,,,2021-04-22,INTERNET TFR TO CHK XXXX
,9.99,,,2021-04-22,"Name.com, Inc POS 720-2492374 CO US 068872 ****"
,10.00,,,2021-04-20,VENMO PAYMENT WEB
,,98.50,,2021-04-19,Michael Dougherty POS Visa Direct CA US 434790 ****
,495.00,,,2021-04-19,BETTERMENT SEC TRANSFER 210418 WEB
,10.00,,,2021-04-19,BETTERMENT SEC TRANSFER 210418 WEB
,10.00,,,2021-04-19,BETTERMENT SEC TRANSFER 210418 WEB
,,100.00,,2021-04-15,INTERNET TFR FRM CHK XXXX
,2.52,,,2021-04-15,FASTWAY MART POS CHICAGO IL US 063414 ****
,,167.42,,2021-04-13,INSTANT PAYROLL 210413 PPD
,8.69,,,2021-04-13,SQ *J'S CORNER H POS CHICAGO IL US 084203 ****
,14.30,,,2021-04-12,OUTBACK 1420 POS SKOKIE IL US 061468 ****
,16.82,,,2021-04-12,OUTBACK 1420 POS SKOKIE IL US 061482 ****
,7.39,,,2021-04-12,MCDONALD'S M7882 POS SKOKIE IL US 097772 ****
,10.00,,,2021-04-12,VENMO PAYMENT WEB
,10.00,,,2021-04-12,BETTERMENT SEC TRANSFER 210411 WEB
,10.00,,,2021-04-12,BETTERMENT SEC TRANSFER 210411 WEB
,20.00,,,2021-04-09,EXXONMOBIL 48 POS CHICAGO IL US 020920 ****
,,100.00,,2021-04-08,INTERNET TFR FRM CHK XXXX
,,224.27,,2021-04-07,INSTANT PAYROLL 210407 PPD
,27.09,,,2021-04-07,JIMMY JOHNS - 56 POS CHICAGO IL US 088118 ****
,,25.00,,2021-04-06,INTERNET TFR FRM CHK XXXX
,15.00,,,2021-04-06,SQ *FINAL TOUCH POS Chicago IL US 063560 ****
,4.57,,,2021-04-06,PARKINGMETER1 87 POS CHICAGO IL US 000623 ****
,19.77,,,2021-04-05,OUTBACK 1420 POS SKOKIE IL US 022440 ****
,4.00,,,2021-04-05,SPIRIT AIRLINES POS IRVING TX US 097408 ****
,20.00,,,2021-04-05,CASH APP*MICHAEL POS XXXX CA US 013100 ****
,50.00,,,2021-04-05,CASH APP*MICHAEL POS XXXX CA US 033705 ****
,10.00,,,2021-04-05,BETTERMENT SEC TRANSFER 210404 WEB
,10.00,,,2021-04-05,BETTERMENT SEC TRANSFER 210404 WEB
,,50.00,,2021-04-05,INTERNET TFR FRM CHK XXXX
,,6.03,,2021-04-05,Michael Dougherty POS Visa Direct CA US 461432 ****
,8.95,,,2021-04-05,MCDONALD'S F866 POS CHICAGO IL US 001693 ****
,215.00,,,2021-04-03,FIRST ASCENT CLI POS CHICAGO IL US 020226 ****
,,79.20,,2021-04-02,Dougherty Mike POS New York City NY US 103777 ****
,20.00,,,2021-04-02,BETTERMENT SEC TRANSFER 210401 WEB
,,100.00,,2021-04-01,INTERNET TFR FRM CHK XXXX
,160.50,,,2021-04-01,GREEN IGUANA REN POS INDIAN SHORES FL US 005729 ****
,,25.00,,2021-03-31,VENMO CASHOUT 210330 PPD
,14.45,,,2021-03-31,BLESSED CUP LLC POS CLEARWATER BE FL US 000025 ****
,10.00,,,2021-03-31,VENMO PAYMENT WEB
,5.00,,,2021-03-30,CASH APP*MICHAEL POS XXXX CA US 078064 ****
,48.15,,,2021-03-30,GREEN IGUANA REN POS INDIAN SHORES FL US 002738 ****
,40.00,,,2021-03-30,CASH APP*MICHAEL POS XXXX CA US 020665 ****
,,30.00,,2021-03-29,INTERNET TFR FRM CHK XXXX
,21.40,,,2021-03-29,BLESSED CUP LLC POS CLEARWATER BE FL US 000047 ****
,45.00,,,2021-03-29,CASH APP*MICHAEL POS XXXX CA US 050229 ****
,10.96,,,2021-03-29,CVS/PHARMACY #03 POS Clearwater Be FL US 034758 ****
,10.00,,,2021-03-29,BETTERMENT SEC TRANSFER 210328 WEB
,10.00,,,2021-03-29,BETTERMENT SEC TRANSFER 210328 WEB
,,45.46,,2021-03-26,INSTANT PAYROLL 210326 PPD
,,37.00,,2021-03-26,VENMO CASHOUT PPD
,,100.00,,2021-03-25,INTERNET TFR FRM CHK XXXX
,10.59,,,2021-03-25,BURGER KING #120 POS NORRIDGE IL US 000120 ****
,7.74,,,2021-03-25,KFC G135532 POS CHICAGO IL US 000021 ****
,,232.27,,2021-03-24,INSTANT PAYROLL 210324 PPD
,3.96,,,2021-03-24,MCDONALD'S F4417 POS CHICAGO IL US 059920 ****
,5.00,,,2021-03-24,CASH APP*MICHAEL POS XXXX CA US 079867 ****
,15.00,,,2021-03-23,CASH APP*MICHAEL POS XXXX CA US 020575 ****
,16.83,,,2021-03-23,OUTBACK 1420 POS SKOKIE IL US 032058 ****
,,43.86,,2021-03-22,INSTANT PAYROLL 210322 PPD
,,80.00,,2021-03-22,VENMO CASHOUT 210320 PPD
,22.44,,,2021-03-22,OUTBACK 1420 POS SKOKIE IL US 012171 ****
,15.00,,,2021-03-22,CASH APP*MICHAEL POS XXXX CA US 064688 ****
,20.00,,,2021-03-22,Coinbase.com L4FVX7J3 WEB
,10.00,,,2021-03-22,BETTERMENT SEC TRANSFER 210321 WEB
,10.00,,,2021-03-22,BETTERMENT SEC TRANSFER 210321 WEB
,200.00,,,2021-03-19,BETTERMENT SEC TRANSFER 210318 WEB
,,100.00,,2021-03-18,INTERNET TFR FRM CHK XXXX
,20.00,,,2021-03-18,EXXONMOBIL 97 POS HARWOOD HEIGH IL US 077919 ****
,10.09,,,2021-03-18,OUTBACK 1420 POS SKOKIE IL US 039878 ****
,,115.55,,2021-03-17,INSTANT PAYROLL 210317 PPD
,46.38,,,2021-03-17,BEST BUY #319 POS NORRIDGE IL US 001471 ****
,15.84,,,2021-03-17,MCDONALD'S F83 POS HARWOOD HEIGH IL US 062115 ****
,12.00,,,2021-03-17,CASH APP*MICHAEL POS XXXX CA US 095421 ****
,400.00,,,2021-03-16,CASH APP*MICHAEL POS XXXX CA US 077221 ****
,9.18,,,2021-03-16,MCDONALD'S M7882 POS SKOKIE IL US 058106 ****
,,362.02,,2021-03-15,Square Inc * Cash App 210313 CCD TXXXX61
,8.96,,,2021-03-15,MCDONALD'S M7882 POS SKOKIE IL US 001561 ****
,15.00,,,2021-03-15,CASH APP*MICHAEL POS XXXX CA US 061947 ****
,10.00,,,2021-03-15,BETTERMENT SEC TRANSFER 210314 WEB
,10.00,,,2021-03-15,BETTERMENT SEC TRANSFER 210314 WEB
,29.74,,,2021-03-13,JERSEY MIKES 270 POS PARK RIDGE IL US 000082 ****
,5.60,,,2021-03-13,OUTBACK 1420 POS SKOKIE IL US 002252 ****
,3.95,,,2021-03-12,MCDONALD'S F83 POS HARWOOD HEIGH IL US 080024 ****
,,100.00,,2021-03-11,INTERNET TFR FRM CHK XXXX
,50.00,,,2021-03-11,INTERNET TFR TO CHK XXXX
,,194.92,,2021-03-10,INSTANT PAYROLL 210310 PPD
,19.72,,,2021-03-10,MCDONALD'S F83 POS HARWOOD HEIGH IL US 054590 ****
,9.29,,,2021-03-10,Subway 39680 POS Chicago IL US 035872 ****
,,64.35,,2021-03-09,Dougherty Mike POS New York City NY US 198522 ****
,20.16,,,2021-03-09,EXXONMOBIL 48 POS CHICAGO IL US 017778 ****
,6.96,,,2021-03-09,MCDONALD'S F83 POS HARWOOD HEIGH IL US 052901 ****
,,20.00,,2021-03-08,INTERNET TFR FRM CHK XXXX
,,4.79,,2021-03-08,Michael Dougherty POS Visa Direct CA US 480588 ****
,21.31,,,2021-03-08,OUTBACK 1420 POS SKOKIE IL US 037918 ****
,13.74,,,2021-03-08,OUTBACK 1420 POS SKOKIE IL US 090066 ****
,10.00,,,2021-03-08,BETTERMENT SEC TRANSFER 210307 WEB
,10.00,,,2021-03-08,BETTERMENT SEC TRANSFER 210307 WEB
,13.46,,,2021-03-06,OUTBACK 1420 POS SKOKIE IL US 022742 ****
,,100.00,,2021-03-04,INTERNET TFR FRM CHK XXXX
,20.00,,,2021-03-04,CASH APP*MICHAEL POS XXXX CA US 085896 ****
,30.00,,,2021-03-04,CASH APP*MICHAEL POS XXXX CA US 008216 ****
,425.00,,,2021-03-04,BETTERMENT SEC TRANSFER 210303 WEB
,,134.07,,2021-03-03,INSTANT PAYROLL 210303 PPD
,,42.72,,2021-03-03,INSTANT PAYROLL 210303 PPD
,3.95,,,2021-03-03,MCDONALD'S F83 POS HARWOOD HEIGH IL US 054189 ****
,215.00,,,2021-03-02,FIRST ASCENT CLI POS CHICAGO IL US 054204 ****
,16.53,,,2021-03-02,SHELL SERVICE ST POS CHICAGO IL US 653083 ****
,12.62,,,2021-03-02,OUTBACK 1420 POS SKOKIE IL US 070540 ****
,20.00,,,2021-03-02,BETTERMENT SEC TRANSFER 210301 WEB
,,327.42,,2021-03-01,Square Inc * Cash App 210227 CCD TXXXX50
,8.51,,,2021-03-01,MCDONALD'S M7882 POS SKOKIE IL US 046356 ****
,3.12,,,2021-03-01,PAYPAL *EBAYINCS POS 402-935-7733 CA US 044940 ****
,24.31,,,2021-03-01,JERSEY MIKES 270 POS PARK RIDGE IL US 000016 ****
,10.52,,,2021-03-01,MCDONALD'S M7882 POS SKOKIE IL US 078684 ****
,8.41,,,2021-03-01,OUTBACK 1420 POS SKOKIE IL US 082933 ****
,10.00,,,2021-03-01,BETTERMENT SEC TRANSFER 210228 WEB
,10.00,,,2021-03-01,BETTERMENT SEC TRANSFER 210228 WEB
,9.39,,,2021-02-27,MCDONALD'S F2930 POS CHICAGO IL US 061360 ****
,9.81,,,2021-02-27,OUTBACK 1420 POS SKOKIE IL US 068284 ****
,,4.03,,2021-02-26,EBAY EDI PYMNTS CCD TXXXXXXT
,,110.00,,2021-02-26,Square Inc * Cash App 210226 CCD TXXXX95
,,30.00,,2021-02-26,INTERNET TFR FRM CHK XXXX
,20.01,,,2021-02-26,JMC FOOD MART POS CHICAGO IL US 992612 ****
,,100.00,,2021-02-25,INTERNET TFR FRM CHK XXXX
,50.00,,,2021-02-25,INTERNET TFR TO CHK XXXX
,26.58,,,2021-02-25,CAVIAR*HONEY BUT POS WWW.DOORDASH. CA US 059371 ****
,,145.75,,2021-02-24,INSTANT PAYROLL 210224 PPD
,,6.00,,2021-02-24,VENMO CASHOUT PPD
,,700.00,,2021-02-23,BETTERMENT SEC TRANSFER 210222 PPD
,700.00,,,2021-02-23,CASH APP*MICHAEL POS XXXX CA US 002047 ****
,6.60,,,2021-02-22,MCDONALD'S M7882 POS SKOKIE IL US 045152 ****
,3.52,,,2021-02-22,MCDONALD'S F866 POS CHICAGO IL US 003271 ****
,22.43,,,2021-02-22,OUTBACK 1420 POS SKOKIE IL US 090552 ****
,300.00,,,2021-02-22,BETTERMENT SEC TRANSFER 210221 WEB
,10.00,,,2021-02-22,BETTERMENT SEC TRANSFER 210221 WEB
,10.00,,,2021-02-22,BETTERMENT SEC TRANSFER 210221 WEB
,20.00,,,2021-02-20,CASH APP*MICHAEL POS XXXX CA US 069834 ****
,13.74,,,2021-02-20,OUTBACK 1420 POS SKOKIE IL US 010120 ****
,,20.00,,2021-02-19,INTERNET TFR FRM CHK XXXX
,9.43,,,2021-02-19,RAISING CANE'S # POS HARWOOD HEIGH IL US 077243 ****
,,100.00,,2021-02-18,INTERNET TFR FRM CHK XXXX
,50.00,,,2021-02-18,INTERNET TFR TO CHK XXXX
,2.22,,,2021-02-18,MCDONALD'S F4417 POS CHICAGO IL US 079375 ****
,1.00,,,2021-02-18,CASH APP*MICHAEL POS XXXX CA US 031577 ****
,20.94,,,2021-02-18,JEWEL OSCO 1296 POS CHICAGO IL US 734827 ****
,,148.59,,2021-02-17,INSTANT PAYROLL 210217 PPD
,,135.46,,2021-02-17,INSTANT PAYROLL 210217 PPD
,15.98,,,2021-02-17,CVS/PHARMACY #03 POS Chicago IL US 042452 ****
,7.93,,,2021-02-17,DUNKIN #342335 Q POS CHICAGO IL US 099542 ****
,8.36,,,2021-02-17,MCDONALD'S F83 POS HARWOOD HEIGH IL US 093801 ****
,300.00,,,2021-02-17,BETTERMENT SEC TRANSFER 210216 WEB
,100.00,,,2021-02-17,BETTERMENT SEC TRANSFER 210216 WEB
,,383.32,,2021-02-16,Square Inc * Cash App 210213 CCD TXXXX42
,8.63,,,2021-02-16,JIMMY JOHNS - 56 POS CHICAGO IL US 043870 ****
,10.00,,,2021-02-16,BETTERMENT SEC TRANSFER 210215 WEB
,10.00,,,2021-02-16,BETTERMENT SEC TRANSFER 210215 WEB
,,20.00,,2021-02-15,INTERNET TFR FRM CHK XXXX
,13.78,,,2021-02-15,DUNKIN #342335 Q POS CHICAGO IL US 099213 ****
,5.81,,,2021-02-15,MCDONALD'S M7882 POS SKOKIE IL US 016280 ****
,22.44,,,2021-02-13,OUTBACK 1420 POS SKOKIE IL US 020147 ****
,,100.00,,2021-02-11,INTERNET TFR FRM CHK XXXX
,9.99,,,2021-02-11,"Name.com, Inc POS 720-2492374 CO US 055494 ****"
,130.00,,,2021-02-11,BETTERMENT SEC TRANSFER 210210 WEB
,1000.00,,,2021-02-10,BETTERMENT SEC TRANSFER 210209 WEB
,,350.00,,2021-02-09,Square Inc * Cash App 210209 CCD TXXXX96
,50.00,,,2021-02-09,INTERNET TFR TO CHK XXXX
,1594.99,,,2021-02-09,BEST BUY 00 POS NORRIDGE IL US 002327 ****
,60.00,,,2021-02-08,7111 W FOSTER AVE. ATM CHICAGO IL US 003160 ****
,10.00,,,2021-02-08,BETTERMENT SEC TRANSFER 210207 WEB
,10.00,,,2021-02-08,BETTERMENT SEC TRANSFER 210207 WEB
,50.00,,,2021-02-05,INTERNET TFR TO CHK XXXX
,,2446.40,,2021-02-05,DEPOSIT FOSTER OFFICE
,,100.00,,2021-02-04,INTERNET TFR FRM CHK XXXX
,215.00,,,2021-02-03,FIRST ASCENT CLI POS CHICAGO IL US 070623 ****
,,8.00,,2021-02-02,VENMO CASHOUT PPD
,10.00,,,2021-02-01,BETTERMENT SEC TRANSFER 210131 WEB
,10.00,,,2021-02-01,BETTERMENT SEC TRANSFER 210131 WEB
,,100.00,,2021-01-28,INTERNET TFR FRM CHK XXXX
,30.00,,,2021-01-27,INTERNET TFR TO CHK XXXX
,,180.00,,2021-01-26,Square Inc * Cash App 210126 CCD TXXXX53
,150.00,,,2021-01-26,BETTERMENT SEC TRANSFER 210125 WEB
,,55.00,,2021-01-25,INTERNET TFR FRM CHK XXXX
,,4.03,,2021-01-25,EBAY EDI PYMNTS CCD TXXXXXXT
,2.79,,,2021-01-25,EBAY.COM/CC POS 888-749-3229 CA US 089243 ****
,10.00,,,2021-01-25,BETTERMENT SEC TRANSFER 210124 WEB
,10.00,,,2021-01-25,BETTERMENT SEC TRANSFER 210124 WEB
,,100.00,,2021-01-21,INTERNET TFR FRM CHK XXXX
,20.00,,,2021-01-21,INTERNET TFR TO CHK XXXX
,2.84,,,2021-01-21,PAYPAL *EBAYINCS POS 402-935-7733 CA US 050132 ****
,,4.77,,2021-01-20,Square Inc * Cash App 210120 CCD TXXXX85
,,15.00,,2021-01-19,VENMO CASHOUT PPD
,,24.62,,2021-01-19,PAYPAL TRANSFER 210116 PPD
,10.00,,,2021-01-19,BETTERMENT SEC TRANSFER 210118 WEB
,10.00,,,2021-01-19,BETTERMENT SEC TRANSFER 210118 WEB
,,30.00,,2021-01-18,INTERNET TFR FRM CHK XXXX
,4.41,,,2021-01-18,MCDONALD'S F83 POS HARWOOD HEIGH IL US 090877 ****
,16.03,,,2021-01-18,BP#8935702NORTHW POS CHICAGO IL US 017122 ****
,1.50,,,2021-01-16,NAYAX AIR 2 POS HUNT VALLEY MD US 015757 ****
,30.90,,,2021-01-15,FIRESTONE9210 POS NORRIDGE IL US 000243 ****
,,100.00,,2021-01-14,INTERNET TFR FRM CHK XXXX
,17.63,,,2021-01-13,MCDONALD'S F83 POS HARWOOD HEIGH IL US 042000 ****
,,0.18,,2021-01-12,PAYPAL VERIFYBANK 210111 PPD
,,0.08,,2021-01-12,PAYPAL VERIFYBANK 210111 PPD
,,20.00,,2021-01-12,INTERNET TFR FRM CHK XXXX
,3.95,,,2021-01-12,MCDONALD'S F83 POS HARWOOD HEIGH IL US 039831 ****
,0.26,,,2021-01-12,PAYPAL VERIFYBANK 210111 PPD
,,6.00,,2021-01-11,INTERNET TFR FRM CHK XXXX
,,5.00,,2021-01-11,INTERNET TFR FRM CHK XXXX
,3.95,,,2021-01-11,MCDONALD'S F83 POS HARWOOD HEIGH IL US 089097 ****
,6.00,,,2021-01-11,CASH APP*MICHAEL POS XXXX CA US 002418 ****
,35.00,,,2021-01-11,CASH APP*MICHAEL POS XXXX CA US 054693 ****
,10.00,,,2021-01-11,BETTERMENT SEC TRANSFER 210110 WEB
,10.00,,,2021-01-11,BETTERMENT SEC TRANSFER 210110 WEB
,7.00,,,2021-01-11,VENMO PAYMENT WEB
,10.00,,,2021-01-09,FIRST ASCENT CLI POS CHICAGO IL US 081837 ****
,26.00,,,2021-01-09,CASH APP*MICHAEL POS XXXX CA US 001033 ****
,15.00,,,2021-01-08,CASH APP*MICHAEL POS XXXX CA US 006391 ****
,4.18,,,2021-01-08,MCDONALD'S F83 POS HARWOOD HEIGH IL US 049971 ****
,,100.00,,2021-01-07,INTERNET TFR FRM CHK XXXX
,16.53,,,2021-01-07,FANTASY COSTUMES POS CHICAGO IL US 037458 ****
,5.73,,,2021-01-07,MCDONALD'S F4417 POS CHICAGO IL US 069277 ****
,,14.75,,2021-01-06,Dougherty Mike POS New York City NY US 186537 ****
,,50.00,,2021-01-04,INTERNET TFR FRM CHK XXXX
,2.21,,,2021-01-04,SQ *PASTIMES INC POS Niles IL US 035815 ****
,19.06,,,2021-01-04,SPORT & GAMING C POS NILES IL US 007706 ****
,15.02,,,2021-01-04,EXXONMOBIL 99 POS NILES IL US 029342 ****
,85.00,,,2021-01-04,FIRST ASCENT CLI POS CHICAGO IL US 007120 ****
,10.00,,,2021-01-04,BETTERMENT SEC TRANSFER 210103 WEB
,10.00,,,2021-01-04,BETTERMENT SEC TRANSFER 210103 WEB
,,6.00,,2021-01-02,INTERNET TFR FRM CHK XXXX
,12.71,,,2021-01-02,SPORT & GAMING C POS NILES IL US 025365 ****
,10.00,,,2021-01-02,CASH APP*MICHAEL POS XXXX CA US 052381 ****
,16.54,,,2021-01-02,DOLLAR TREE POS CHICAGO IL US 028758 ****
,,100.00,,2020-12-31,INTERNET TFR FRM CHK XXXX
,,488.07,,2020-12-31,Michael Dougherty POS Visa Direct CA US 338660 ****
,500.00,,,2020-12-31,6210 N MILWAUKEE AV ATM CHICAGO IL US 007110 ****
,20.00,,,2020-12-31,CASH APP*MICHAEL POS XXXX CA US 044308 ****
,10.00,,,2020-12-30,CASH APP*MICHAEL POS XXXX CA US 035964 ****
,20.00,,,2020-12-29,CASH APP*MICHAEL POS XXXX CA US 092528 ****
,,114.00,,2020-12-28,DEPOSIT FOSTER OFFICE
,10.00,,,2020-12-28,CASH APP*MICHAEL POS XXXX CA US 025075 ****
,13.00,,,2020-12-28,CASH APP*MICHAEL POS XXXX CA US 003068 ****
,20.00,,,2020-12-28,CASH APP*MICHAEL POS XXXX CA US 080061 ****
,5.00,,,2020-12-28,CASH APP*MICHAEL POS XXXX CA US 015662 ****
,5.00,,,2020-12-28,CASH APP*MICHAEL POS XXXX CA US 051507 ****
,10.00,,,2020-12-28,BETTERMENT SEC TRANSFER 201227 WEB
,10.00,,,2020-12-28,BETTERMENT SEC TRANSFER 201227 WEB
,,100.00,,2020-12-24,INTERNET TFR FRM CHK XXXX
,25.00,,,2020-12-24,INTERNET TFR TO CHK XXXX
,,18.00,,2020-12-22,INTERNET TFR FRM CHK XXXX
,4.40,,,2020-12-21,MCDONALD'S F83 POS HARWOOD HEIGH IL US 022265 ****
,3.95,,,2020-12-21,MCDONALD'S F83 POS HARWOOD HEIGH IL US 098255 ****
,120.00,,,2020-12-21,CASH APP*MICHAEL POS XXXX CA US 069239 ****
,5.95,,,2020-12-21,MCDONALD'S F866 POS CHICAGO IL US 048234 ****
,2.63,,,2020-12-21,DUNKIN #342335 Q POS CHICAGO IL US 088837 ****
,6.93,,,2020-12-21,MCDONALD'S F83 POS HARWOOD HEIGH IL US 028797 ****
,10.00,,,2020-12-21,BETTERMENT SEC TRANSFER 201220 WEB
,10.00,,,2020-12-21,BETTERMENT SEC TRANSFER 201220 WEB
,5.00,,,2020-12-19,CASH APP*MICHAEL POS XXXX CA US 089824 ****
,,100.00,,2020-12-17,INTERNET TFR FRM CHK XXXX
,10.00,,,2020-12-17,CASH APP*MICHAEL POS XXXX CA US 007636 ****
,31.13,,,2020-12-17,TARGET T-1888 POS Norridge IL US 077537 ****
,,35.00,,2020-12-16,INTERNET TFR FRM CHK XXXX
,34.68,,,2020-12-16,JERSEY MIKES 270 POS PARK RIDGE IL US 000049 ****
,,80.08,,2020-12-15,DEPOSIT FOSTER OFFICE
,3.95,,,2020-12-15,MCDONALD'S F83 POS HARWOOD HEIGH IL US 065866 ****
,14.76,,,2020-12-15,MCDONALD'S F83 POS HARWOOD HEIGH IL US 065583 ****
,,27.00,,2020-12-14,INTERNET TFR FRM CHK XXXX
,9.23,,,2020-12-14,MCDONALD'S F83 POS HARWOOD HEIGH IL US 023621 ****
,4.64,,,2020-12-14,MCDONALD'S F866 POS CHICAGO IL US 072982 ****
,60.00,,,2020-12-14,CASH APP*MICHAEL POS XXXX CA US 039882 ****
,10.00,,,2020-12-14,BETTERMENT SEC TRANSFER 201213 WEB
,10.00,,,2020-12-14,BETTERMENT SEC TRANSFER 201213 WEB
,37.11,,,2020-12-12,CORNER BAKERY 00 POS SKOKIE IL US 000020 ****
,,400.00,,2020-12-11,INTERNET TFR FRM CHK XXXX
,,35.00,,2020-12-11,INTERNET TFR FRM CHK XXXX
,400.00,,,2020-12-11,CASH APP*MICHAEL POS XXXX CA US 019630 ****
,,100.00,,2020-12-10,INTERNET TFR FRM CHK XXXX
,72.00,,,2020-12-08,CASH APP*MICHAEL POS XXXX CA US 026438 ****
,13.44,,,2020-12-07,CULVERS HARWOOD POS HARWOOD HEIGH IL US 053924 ****
,6.41,,,2020-12-05,MCDONALD'S F4417 POS CHICAGO IL US 020231 ****
,,100.00,,2020-12-03,INTERNET TFR FRM CHK XXXX
,8.00,,,2020-12-03,INTERNET TFR TO CHK XXXX
,200.00,,,2020-12-03,CASH APP*MIKE DO POS XXXX CA US 007675 ****
,200.00,,,2020-12-03,CASH APP*MICHAEL POS XXXX CA US 063666 ****
,23.00,,,2020-12-02,INTERNET TFR TO CHK XXXX
,,7.44,,2020-12-02,Dougherty Mike POS New York City NY US 232558 ****
,,8.00,,2020-12-02,INTERNET TFR FRM CHK XXXX
,600.00,,,2020-12-02,CASH APP*MIKE DO POS XXXX CA US 085530 ****
,85.00,,,2020-12-02,FIRST ASCENT CLI POS CHICAGO IL US 062545 ****
,2.75,,,2020-12-02,FIRST ASCENT CLI POS CHICAGO IL US 056646 ****
,,10.17,,2020-11-30,"Goldman Sachs Ba P2P WEB Dougherty,Kathl"
,2.22,,,2020-11-30,MCDONALD'S F866 POS CHICAGO IL US 004386 ****
,1.06,,,2020-11-30,WALGREENS STORE POS CHICAGO IL US 206116 ****
,140.00,,,2020-11-27,INTERNET TFR TO CHK XXXX
,,55.00,,2020-11-27,INTERNET TFR FRM CHK XXXX
,19.49,,,2020-11-27,MCDONALD'S F83 POS HARWOOD HEIGH IL US 008650 ****
,6.41,,,2020-11-27,MCDONALD'S F866 POS CHICAGO IL US 015376 ****
,55.10,,,2020-11-27,JEWEL OSCO 1296 POS CHICAGO IL US 778164 ****
,,212.00,,2020-11-25,"Goldman Sachs Ba P2P WEB Dougherty,Kathl"
,,1020.00,,2020-11-24,INTERNET TFR FRM CHK XXXX
,6.37,,,2020-11-24,MCDONALD'S F83 POS HARWOOD HEIGH IL US 085827 ****
,15.12,,,2020-11-23,EXXONMOBIL 97 POS LINCOLNWOOD IL US 072958 ****
,26.71,,,2020-11-23,JEWEL OSCO 3470 POS CHICAGO IL US 863438 ****
,10.40,,,2020-11-23,Subway 39680 POS Chicago IL US 044873 ****
,6.65,,,2020-11-23,DD/BR #343093 Q3 POS CHICAGO IL US 066739 ****
,,30.00,,2020-11-21,INTERNET TFR FRM CHK XXXX
,,400.00,,2020-11-21,INTERNET TFR FRM CHK XXXX
,100.00,,,2020-11-21,INTERNET TFR TO CHK XXXX
,312.48,,,2020-11-21,GUITAR CENTER #3 POS ARLINGTON HEI IL US 275429 ****
,13.97,,,2020-11-20,TWINSGYROS POS HARWOODHEIGH IL US 041412 ****
,10.00,,,2020-11-20,GOLDMAN SACHS BA COLLECTION WEB
,,75.00,,2020-11-19,INTERNET TFR FRM CHK XXXX
,11.68,,,2020-11-19,CVS/PHARMACY #08 POS Chicago IL US 014649 ****
,17.23,,,2020-11-18,WENDYS #0981 POS CHICAGO IL US 432205 ****
,4.41,,,2020-11-16,MCDONALD'S F83 POS HARWOOD HEIGH IL US 007647 ****
,34.93,,,2020-11-16,PORTILLOS ADDISO POS OAK BROOK IL US 000733 ****
,18.09,,,2020-11-16,SHELL SERVICE ST POS CHICAGO IL US 057474 ****
,60.00,,,2020-11-13,5726 N. NAGLE AVE ATM CHICAGO IL US 005646 ****
,2.00,,,2020-11-13,TERMINAL SURCHARGE
,10.00,,,2020-11-13,GOLDMAN SACHS BA COLLECTION WEB
,,75.00,,2020-11-12,INTERNET TFR FRM CHK XXXX
,30.01,,,2020-11-12,VENMO PAYMENT WEB
,9.14,,,2020-11-10,CHIPOTLE ONLINE POS CHIPOTLE.COM CA US 015314 ****
,,42.00,,2020-11-09,INTERNET TFR FRM CHK XXXX
,42.45,,,2020-11-09,CAVIAR*HONEY BUT POS WWW.DOORDASH. CA US 020054 ****
,17.98,,,2020-11-09,"Name.com, Inc POS 720-2492374 CO US 006494 ****"
,6.15,,,2020-11-09,MCDONALD'S F83 POS HARWOOD HEIGH IL US 052832 ****
,8.26,,,2020-11-06,THE HALAL GUYS - POS SKOKIE IL US 056885 ****
,10.00,,,2020-11-06,GOLDMAN SACHS BA COLLECTION WEB
,,75.00,,2020-11-05,INTERNET TFR FRM CHK XXXX
,6.41,,,2020-11-05,MCDONALD'S F866 POS CHICAGO IL US 006057 ****
,3.95,,,2020-11-04,MCDONALD'S F83 POS HARWOOD HEIGH IL US 097467 ****
,,20.00,,2020-11-03,VENMO CASHOUT PPD
,,25.00,,2020-11-02,INTERNET TFR FRM CHK XXXX
,,14.00,,2020-10-31,INTERNET TFR FRM CHK XXXX
,13.98,,,2020-10-31,JEWEL OSCO 1296 POS CHICAGO IL US 195121 ****
,24.18,,,2020-10-31,GUITAR CENTER #3 POS ARLINGTON HEI IL US 495142 ****
,,75.00,,2020-10-30,INTERNET TFR FRM CHK XXXX
,7.52,,,2020-10-30,MCDONALD'S F4417 POS CHICAGO IL US 047402 ****
,10.00,,,2020-10-30,GOLDMAN SACHS BA COLLECTION WEB
,23.17,,,2020-10-29,CHICK-FIL-A #043 POS NILES IL US 075204 ****
,7.95,,,2020-10-26,MCDONALD'S F866 POS CHICAGO IL US 077208 ****
,3.13,,,2020-10-24,PARKINGMETER1 87 POS CHICAGO IL US 000842 ****
,10.00,,,2020-10-23,GOLDMAN SACHS BA COLLECTION WEB
,,75.00,,2020-10-22,INTERNET TFR FRM CHK XXXX
,,10.00,,2020-10-21,INTERNET TFR FRM CHK XXXX
,9.00,,,2020-10-21,CASH APP*RYAN MC POS XXXX CA US 077430 ****
,25.64,,,2020-10-20,HOT WOKS COOL SU POS 773-2821818 IL US 021227 ****
,,2.24,,2020-10-19,Dougherty Mike POS New York City NY US 344475 ****
,6.73,,,2020-10-19,MCDONALD'S F56 POS CHICAGO IL US 032502 ****
,13.41,,,2020-10-19,CHIPOTLE 0089 POS SKOKIE IL US 000237 ****
,9.99,,,2020-10-19,DOORDASH DASHPAS POS WWW.DOORDASH. CA US 050854 ****
,13.29,,,2020-10-16,BLAZE PIZZA NILE POS NILES IL US 056939 ****
,10.00,,,2020-10-16,GOLDMAN SACHS BA COLLECTION WEB
,,80.00,,2020-10-15,INTERNET TFR FRM CHK XXXX
,45.20,,,2020-10-14,CAVIAR*HONEY BUT POS WWW.DOORDASH. CA US 035918 ****
,,30.00,,2020-10-12,INTERNET TFR FRM CHK XXXX
,13.83,,,2020-10-12,CAVIAR*HONEY BUT POS WWW.DOORDASH. CA US 053941 ****
,2.24,,,2020-10-12,7-ELEVEN POS CHICAGO IL US 976121 ****
,16.93,,,2020-10-12,BP#8935371PETERS POS CHICAGO IL US 074809 ****
,15.59,,,2020-10-10,CULVERS OF SKOKI POS SKOKIE IL US 011999 ****
,10.00,,,2020-10-09,GOLDMAN SACHS BA COLLECTION WEB
,,75.00,,2020-10-08,INTERNET TFR FRM CHK XXXX
,11.64,,,2020-10-07,DUNKIN #342335 Q POS CHICAGO IL US 072403 ****
,,10.00,,2020-10-06,INTERNET TFR FRM CHK XXXX
,,35.00,,2020-10-05,INTERNET TFR FRM CHK XXXX
,,40.00,,2020-10-05,"Goldman Sachs Ba P2P WEB Dougherty,Kathl"
,32.65,,,2020-10-05,CAVIAR*HONEY BUT POS WWW.DOORDASH. CA US 036596 ****
,40.00,,,2020-10-05,VENMO PAYMENT WEB
,9.43,,,2020-10-03,RAISING CANE'S # POS HARWOOD HEIGH IL US 045808 ****
,4.09,,,2020-10-02,DD/BR #304935 Q3 POS CHICAGO IL US 043475 ****
,90.00,,,2020-10-02,GOLDMAN SACHS BA COLLECTION WEB
,10.00,,,2020-10-02,GOLDMAN SACHS BA COLLECTION WEB
,,75.00,,2020-10-01,INTERNET TFR FRM CHK XXXX
,17.86,,,2020-10-01,SHELL SERVICE ST POS NILES IL US 024639 ****
,8.30,,,2020-10-01,Subway 2644 POS Chicago IL US 079872 ****
,5.50,,,2020-09-26,DUNKIN #342335 Q POS CHICAGO IL US 069942 ****
,10.00,,,2020-09-25,GOLDMAN SACHS BA COLLECTION WEB
,,75.00,,2020-09-24,INTERNET TFR FRM CHK XXXX
,1.57,,,2020-09-24,JEWEL OSCO 3470 POS CHICAGO IL US 077449 ****
,4.51,,,2020-09-24,JEWEL OSCO 1296 POS CHICAGO IL US 506241 ****
,,3.00,,2020-09-22,VENMO REFUND PPD
,6.64,,,2020-09-22,MCDONALD'S F56 POS CHICAGO IL US 092509 ****
,3.00,,,2020-09-21,VENMO PAYMENT WEB
,30.20,,,2020-09-19,CAVIAR*ALEXANDER POS WWW.DOORDASH. CA US 012362 ****
,60.51,,,2020-09-19,CAVIAR*ZOKU POS WWW.DOORDASH. CA US 071078 ****
,,40.00,,2020-09-18,INTERNET TFR FRM CHK XXXX
,,21.75,,2020-09-18,Dougherty Mike POS New York City NY US 269612 ****
,23.78,,,2020-09-18,CAVIAR*HONEY BUT POS WWW.DOORDASH. CA US 074567 ****
,10.00,,,2020-09-18,GOLDMAN SACHS BA COLLECTION WEB
,,75.00,,2020-09-17,INTERNET TFR FRM SAV XXXX
,22.00,,,2020-09-17,VENMO PAYMENT WEB
,31.00,,,2020-09-16,INTERNET TFR TO CHK XXXX
,,40.00,,2020-09-16,INTERNET TFR FRM CHK XXXX
,,60.00,,2020-09-16,INTERNET TFR FRM CHK XXXX
,60.00,,,2020-09-16,WITHDRAWAL FOSTER OFFICE
,15.50,,,2020-09-16,SHELL SERVICE ST POS CHICAGO IL US 017856 ****
,,15.00,,2020-09-14,INTERNET TFR FRM CHK XXXX
,7.63,,,2020-09-14,MCDONALD'S F866 POS CHICAGO IL US 022852 ****
,2.25,,,2020-09-14,WALGREENS STORE POS CHICAGO IL US 255756 ****
,50.03,,,2020-09-12,THE BAD APPLE BA POS CHICAGO IL US 012782 ****
,10.00,,,2020-09-11,GOLDMAN SACHS BA COLLECTION WEB
,,75.00,,2020-09-10,INTERNET TFR FRM CHK XXXX
,4.97,,,2020-09-08,DD/BR #304935 Q3 POS CHICAGO IL US 038725 ****
,7.61,,,2020-09-08,AUNTIE ANNES POS NORRIDGE IL US 000039 ****
,44.02,,,2020-09-04,CAVIAR*SMALL CHE POS WWW.DOORDASH. CA US 061173 ****
,10.00,,,2020-09-04,GOLDMAN SACHS BA COLLECTION WEB
,,75.00,,2020-09-03,INTERNET TFR FRM CHK XXXX
,16.80,,,2020-09-02,NANDO S OF OLD O POS SKOKIE IL US 042170 ****
,,20.00,,2020-09-01,INTERNET TFR FRM CHK XXXX
,,20.00,,2020-09-01,INTERNET TFR FRM CHK XXXX
,,18.75,,2020-09-01,Dougherty Mike POS New York City NY US 147004 ****
,20.00,,,2020-09-01,INTERNET TFR TO CHK XXXX
,20.00,,,2020-09-01,EXXONMOBIL 48 POS CHICAGO IL US 044902 ****
,80.00,,,2020-08-31,WITHDRAWAL LINCOLNWOOD OFF
,,5.00,,2020-08-31,INTERNET TFR FRM CHK XXXX
,6.00,,,2020-08-31,VENMO PAYMENT WEB
,20.00,,,2020-08-29,INTERNET TFR TO CHK XXXX
,18.00,,,2020-08-28,INTERNET TFR TO CHK XXXX
,10.00,,,2020-08-28,GOLDMAN SACHS BA COLLECTION WEB
,,75.00,,2020-08-27,INTERNET TFR FRM CHK XXXX
,60.00,,,2020-08-26,WITHDRAWAL FOSTER OFFICE
,15.00,,,2020-08-26,VENMO PAYMENT WEB
,5.00,,,2020-08-24,DEBIT CARD REPLACEMENT FEE
,10.00,,,2020-08-21,GOLDMAN SACHS BA COLLECTION WEB
,,75.00,,2020-08-20,INTERNET TFR FRM CHK XXXX
,10.00,,,2020-08-14,GOLDMAN SACHS BA COLLECTION WEB
,50.00,,,2020-08-13,INTERNET TFR TO CHK XXXX
,,75.00,,2020-08-13,INTERNET TFR FRM CHK XXXX
,40.00,,,2020-08-11,WITHDRAWAL FOSTER OFFICE
,10.00,,,2020-08-10,GOLDMAN SACHS BA COLLECTION WEB
,,75.00,,2020-08-06,INTERNET TFR FRM CHK XXXX
,,65.00,,2020-08-03,INTERNET TFR FRM CHK XXXX
,65.00,,,2020-08-03,INTERNET TFR TO CHK XXXX
,,40.00,,2020-08-01,INTERNET TFR FRM CHK XXXX
,5.00,,,2020-07-31,GOLDMAN SACHS BA COLLECTION WEB
,,5.00,,2020-07-29,INTERNET TFR FRM CHK XXXX
,14.00,,,2020-07-29,VENMO* POS Visa Direct NY US 695128 ****
,,10.00,,2020-07-28,INTERNET TFR FRM CHK XXXX
,20.00,,,2020-07-28,VENMO* POS Visa Direct NY US 455724 ****
,5.00,,,2020-07-28,CASH APP*RYAN MC POS XXXX CA US 004100 ****
,22.45,,,2020-07-27,A EAGLE OUTFTR POS BOSTON MA US 384396 ****
,10.38,,,2020-07-27,STARBUCKS STORE POS CAMBRIDGE MA US 036505 ****
,,40.00,,2020-07-27,INTERNET TFR FRM CHK XXXX
,3.99,,,2020-07-27,WALGREENS STORE POS BOSTON MA US 913180 ****
,11.72,,,2020-07-27,POKE BAR AND KIT POS BOSTON MA US 058869 ****
,1.12,,,2020-07-23,CVS/PHARMACY #03 POS Chicago IL US 028739 ****
,15.00,,,2020-07-23,SHELL SERVICE ST POS CHICAGO IL US 055118 ****
,3.06,,,2020-07-23,MCDONALD'S M6867 POS EVANSTON IL US 037830 ****
,,200.00,,2020-07-22,INTERNET TFR FRM CHK XXXX
,,60.00,,2020-07-22,"Goldman Sachs Ba P2P WEB Dougherty,Kathl"
,60.00,,,2020-07-22,730 W GRAND AVE ATM CHICAGO IL US 006790 ****
,3.50,,,2020-07-22,TERMINAL SURCHARGE
,6.76,,,2020-07-22,FIRST ASCENT CLI POS CHICAGO IL US 029736 ****
,39.00,,,2020-07-22,HOLLISTER #648 1 POS SKOKIE IL US 421440 ****
,82.69,,,2020-07-22,FINISH-LINE #033 POS SKOKIE IL US 823223 ****
,30.00,,,2020-07-22,ANTHROPOLOGIE # POS SKOKIE IL US 856830 ****
,2.20,,,2020-07-21,MCDONALD'S F866 POS CHICAGO IL US 043960 ****
,12.00,,,2020-07-21,VENMO* POS Visa Direct NY US 478539 ****
,,50.00,,2020-07-20,INTERNET TFR FRM CHK XXXX
,28.67,,,2020-07-20,BUTERA MARKET #8 POS HARWOOD HTS IL US 897558 ****
,24.70,,,2020-07-17,SQ *MAKISU SUSHI POS Skokie IL US 049991 ****
,5.00,,,2020-07-17,VENMO* POS Visa Direct NY US 288195 ****
,2.59,,,2020-07-17,BP#1700756N CENT POS CHICAGO IL US 018005 ****
,8.63,,,2020-07-17,DD/BR #304935 Q3 POS CHICAGO IL US 030620 ****
,5.00,,,2020-07-17,GOLDMAN SACHS BA COLLECTION WEB
,15.77,,,2020-07-16,12 - EC - LOU MA POS HIGHLAND PARK IL US 082488 ****
,,65.00,,2020-07-15,INTERNET TFR FRM CHK XXXX
,6.59,,,2020-07-15,WALGREENS STORE POS HIGHLAND PARK IL US 924864 ****
,3.31,,,2020-07-14,DUNKIN #342335 Q POS CHICAGO IL US 051829 ****
,5.50,,,2020-07-14,FIRST ASCENT CLI POS CHICAGO IL US 069955 ****
,20.00,,,2020-07-13,CASH APP*RYAN MC POS XXXX CA US 047414 ****
,4.99,,,2020-07-13,DUNKIN #342335 Q POS CHICAGO IL US 051183 ****
,3.73,,,2020-07-13,MCDONALD'S F83 POS HARWOOD HEIGH IL US 001697 ****
,10.57,,,2020-07-13,POTBELLY #313 POS CHICAGO IL US 081545 ****
,14.35,,,2020-07-13,BUFFALO WILD WIN POS SKOKIE IL US 065115 ****
,,50.00,,2020-07-11,INTERNET TFR FRM CHK XXXX
,,19.75,,2020-07-11,Dougherty Mike POS New York City NY US 624287 ****
,40.00,,,2020-07-10,5337 W. DEVON AVE ATM CHICAGO IL US 006704 ****
,3.00,,,2020-07-10,TERMINAL SURCHARGE
,4.00,,,2020-07-10,PARKINGMETER2 87 POS CHICAGO IL US 080208 ****
,2.48,,,2020-07-09,JEWEL OSCO 3484 POS NILES IL US 700511 ****
,30.00,,,2020-07-09,VENMO* POS Visa Direct NY US 262674 ****
,300.00,,,2020-07-08,INTERNET TFR TO CHK XXXX
,,66.00,,2020-07-06,INTERNET TFR FRM CHK XXXX
,10.00,,,2020-07-06,VENMO* POS Visa Direct NY US 642214 ****
,5.00,,,2020-07-03,GOLDMAN SACHS BA COLLECTION WEB
,7.47,,,2020-07-02,DUNKIN #342335 Q POS CHICAGO IL US 049048 ****
,66.00,,,2020-07-02,FIRST ASCENT CLI POS CHICAGO IL US 023339 ****
,8.91,,,2020-07-02,THE HALAL GUYS - POS CHICAGO IL US 032457 ****
,6.63,,,2020-07-01,MCDONALD'S F866 POS CHICAGO IL US 079369 ****
,9.89,,,2020-07-01,MCDONALD'S F83 POS HARWOOD HEIGH IL US 058788 ****
,,400.00,,2020-06-29,"Goldman Sachs Ba P2P WEB Dougherty,Kathl"
,22.47,,,2020-06-29,TST* SUSHI SONG POS DEERRFIELD BE FL US 014473 ****
,,20.00,,2020-06-27,INTERNET TFR FRM CHK XXXX
,,15.00,,2020-06-27,INTERNET TFR FRM CHK XXXX
,,20.00,,2020-06-22,INTERNET TFR FRM CHK XXXX
,5.00,,,2020-06-19,GOLDMAN SACHS BA COLLECTION WEB
,6.63,,,2020-06-13,MCDONALD'S F866 POS CHICAGO IL US 050075 ****
,,5.00,,2020-06-12,INTERNET TFR FRM CHK XXXX
,11.54,,,2020-06-12,PENN STATION 316 POS SKOKIE IL US 007338 ****
,46.07,,,2020-06-12,PENN STATION 316 POS SKOKIE IL US 007346 ****
,,12.00,,2020-06-11,INTERNET TFR FRM CHK XXXX
,,50.00,,2020-06-11,INTERNET TFR FRM CHK XXXX
,8.75,,,2020-06-11,DUNKIN #342335 Q POS CHICAGO IL US 043902 ****
,3.19,,,2020-06-09,DUNKIN #342335 Q POS CHICAGO IL US 043504 ****
,8.41,,,2020-06-09,MCDONALD'S F83 POS HARWOOD HEIGH IL US 029143 ****
,,29.55,,2020-06-08,Mike Dougherty POS Visa Direct CA US 214457 ****
,,24.75,,2020-06-08,Dougherty Mike POS New York City NY US 488410 ****
,,20.75,,2020-06-08,Dougherty Mike POS New York City NY US 273935 ****
,,90.00,,2020-06-08,DEPOSIT FOSTER OFFICE
,80.00,,,2020-06-08,INTERNET TFR TO CHK XXXX
,3.07,,,2020-06-08,JEWEL OSCO 1296 POS CHICAGO IL US 100223 ****
,60.00,,,2020-06-08,GOLDMAN SACHS BA COLLECTION WEB
,5.00,,,2020-06-05,GOLDMAN SACHS BA COLLECTION WEB
,,29.55,,2020-06-01,Mike Dougherty POS Visa Direct CA US 275877 ****
,,79.20,,2020-06-01,Dougherty Mike POS New York City NY US 111993 ****
,125.00,,,2020-06-01,GOLDMAN SACHS BA COLLECTION WEB
,,8.00,,2020-05-26,INTERNET TFR FRM CHK XXXX
,,15.00,,2020-05-26,INTERNET TFR FRM CHK XXXX
,6.00,,,2020-05-26,DUNKIN #342335 Q POS CHICAGO IL US 039753 ****
,10.81,,,2020-05-26,MCDONALD'S F866 POS CHICAGO IL US 003772 ****
,,6.00,,2020-05-23,INTERNET TFR FRM CHK XXXX
,,9.75,,2020-05-22,Dougherty Mike POS New York City NY US 208187 ****
,,19.75,,2020-05-22,Dougherty Mike POS New York City NY US 520829 ****
,5.73,,,2020-05-22,MCDONALD'S F866 POS CHICAGO IL US 073512 ****
,35.00,,,2020-05-22,ZEL*PAUL ROTH POS Visa Direct AZ US 806510 ****
,150.00,,,2020-05-22,College Savings ACH 200521 WEB
,5.00,,,2020-05-22,GOLDMAN SACHS BA COLLECTION WEB
,31.25,,,2020-05-21,JIMMY JOHNS - 56 POS 773-625-2551 IL US 003083 ****
,50.00,,,2020-05-21,GOLDMAN SACHS BA COLLECTION WEB
,,10.00,,2020-05-20,INTERNET TFR FRM CHK XXXX
,,32.00,,2020-05-20,INTERNET TFR FRM CHK XXXX
,,300.00,,2020-05-20,INTERNET TFR FRM CHK XXXX
,100.00,,,2020-05-20,INTERNET TFR TO CHK XXXX
,2.03,,,2020-05-20,CVS/PHARMACY #03 POS Chicago IL US 027304 ****
,4.90,,,2020-05-20,CVS/PHARMACY #03 POS Chicago IL US 027328 ****
,,20.00,,2020-05-15,INTERNET TFR FRM CHK XXXX
,3.19,,,2020-05-13,DUNKIN #342335 Q POS CHICAGO IL US 037525 ****
,150.00,,,2020-05-08,GOLDMAN SACHS BA COLLECTION WEB
,5.00,,,2020-05-08,GOLDMAN SACHS BA COLLECTION WEB
,3.52,,,2020-05-07,CULVERS HARWOOD POS HARWOOD HEIGH IL US 005507 ****
,26.88,,,2020-05-07,RAISING CANE'S # POS HARWOOD HEIGH IL US 033196 ****
,,28.00,,2020-05-06,INTERNET TFR FRM CHK XXXX
,100.00,,,2020-05-06,College Savings ACH 200505 WEB
,,100.00,,2020-05-05,INTERNET TFR FRM CHK XXXX
,9.35,,,2020-05-05,DUNKIN #342335 Q POS CHICAGO IL US 036019 ****
,,20.00,,2020-05-04,INTERNET TFR FRM CHK XXXX
,10.00,,,2020-05-04,BT EVERYDAYHERO3 POS 213-293-1133 SC US 044377 ****
,7.49,,,2020-05-04,WENDYS #0981 POS CHICAGO IL US 328673 ****
,5.78,,,2020-05-04,MCDONALD'S F83 POS HARWOOD HEIGH IL US 033701 ****
,20.00,,,2020-05-02,INTERNET TFR TO CHK XXXX
,100.00,,,2020-05-02,ALZHEIMERS ASSOC POS HTTPSWWW.ALZ. IL US 066555 ****
,14.52,,,2020-05-02,JEWEL OSCO 1296 POS CHICAGO IL US 521336 ****
,7.92,,,2020-04-30,DUNKIN #342335 Q POS CHICAGO IL US 035041 ****
,,259.00,,2020-04-29,IRS TREAS 310 TAX REF 042920 PPD
,1.43,,,2020-04-29,MCDONALD'S F866 POS CHICAGO IL US 009367 ****
,3.86,,,2020-04-29,MCDONALD'S F866 POS CHICAGO IL US 009366 ****
,,60.00,,2020-04-28,INTERNET TFR FRM CHK XXXX
,5.52,,,2020-04-28,DD/BR #304935 Q3 POS CHICAGO IL US 018892 ****
,34.80,,,2020-04-28,CHICK-FIL-A #043 POS 833-637-8872 IL US 048081 ****
,,55.00,,2020-04-27,INTERNET TFR FRM SAV XXXX
,,20.00,,2020-04-27,INTERNET TFR FRM SAV XXXX
,60.00,,,2020-04-27,INTERNET TFR TO SAV XXXX
,,50.00,,2020-04-27,INTERNET TFR FRM CHK XXXX
,7.70,,,2020-04-27,DUNKIN #342335 Q POS CHICAGO IL US 034286 ****
,5.71,,,2020-04-27,MARIANOS #510 POS HARWOOD HEIGH IL US 511653 ****
,4.73,,,2020-04-27,DUNKIN #342335 Q POS CHICAGO IL US 034622 ****
,5.50,,,2020-04-27,POPEYES 11027 POS CHICAGO IL US 000668 ****
,17.02,,,2020-04-27,SAVE & SHOP MARK POS CHICAGO IL US 047192 ****
,7.70,,,2020-04-25,DUNKIN #342335 Q POS CHICAGO IL US 034095 ****
,,15.00,,2020-04-22,INTERNET TFR FRM CHK XXXX
,13.26,,,2020-04-20,SAVE & SHOP MARK POS CHICAGO IL US 095521 ****
,,10.00,,2020-04-17,INTERNET TFR FRM CHK XXXX
,,10.00,,2020-04-17,INTERNET TFR FRM CHK XXXX
,15.00,,,2020-04-15,VENMO* POS Visa Direct NY US 269636 ****
,29.59,,,2020-04-11,JIMMY JOHNS - 56 POS 773-625-2551 IL US 064557 ****
,,30.00,,2020-04-10,INTERNET TFR FRM CHK XXXX
,,20.00,,2020-04-03,INTERNET TFR FRM CHK XXXX
,22.95,,,2020-04-03,JIMMY JOHNS - 56 POS CHICAGO IL US 076899 ****
,8.58,,,2020-04-03,JEWEL OSCO 1296 POS CHICAGO IL US 274886 ****
,,20.00,,2020-04-02,INTERNET TFR FRM CHK XXXX
,5.89,,,2020-03-31,MCDONALD'S F4900 POS MORTON GROVE IL US 086134 ****
,,15.00,,2020-03-30,INTERNET TFR FRM CHK XXXX
,6.93,,,2020-03-30,MARIANOS #524 POS NORTHFIELD IL US 503278 ****
,19.63,,,2020-03-25,JIMMY JOHNS - 56 POS 773-625-2551 IL US 055844 ****
,13.22,,,2020-03-21,PENN STATION 316 POS SKOKIE IL US 072540 ****
,,320.00,,2020-03-20,INTERNET TFR FRM CHK XXXX
,,40.00,,2020-03-20,INTERNET TFR FRM CHK XXXX
,331.49,,,2020-03-20,BEST BUY #319 POS NORRIDGE IL US 230236 ****
,10.39,,,2020-03-16,CHICK-FIL-A #032 POS CHICAGO IL US 017626 ****
,3.19,,,2020-03-16,MCDONALD'S F83 POS HARWOOD HEIGH IL US 011531 ****
,15.00,,,2020-03-14,INTERNET TFR TO CHK XXXX
,2.72,,,2020-03-14,9640 AMC ONLINE POS 888-440-4262 KS US 038720 ****
,,5.00,,2020-03-13,INTERNET TFR FRM CHK XXXX
,,30.00,,2020-03-13,INTERNET TFR FRM CHK XXXX
,7.02,,,2020-03-12,FIRST ASCENT CLI POS CHICAGO IL US 052775 ****
,,12.00,,2020-03-10,INTERNET TFR FRM CHK XXXX
,6.60,,,2020-03-10,SAVE & SHOP MARK POS CHICAGO IL US 120538 ****
,,10.00,,2020-03-09,INTERNET TFR FRM CHK XXXX
,6.00,,,2020-03-05,VENMO* POS Visa Direct NY US 635594 ****
,3.51,,,2020-03-04,FIRST ASCENT CLI POS CHICAGO IL US 004190 ****
,9.72,,,2020-03-04,CULVERS OF 6 COR POS CHICAGO IL US 007907 ****
,6.41,,,2020-03-04,CULVERS OF 6 COR POS CHICAGO IL US 010732 ****
,,20.00,,2020-03-03,INTERNET TFR FRM CHK XXXX
,79.00,,,2020-03-03,FIRST ASCENT CLI POS CHICAGO IL US 002227 ****
,,15.00,,2020-03-02,INTERNET TFR FRM CHK XXXX
,,80.00,,2020-03-02,INTERNET TFR FRM CHK XXXX
,10.71,,,2020-03-02,STEAMGAMES.COM 4 POS 425-8899642 WA US 071872 ****
,11.62,,,2020-03-02,CULVERS OF 6 COR POS CHICAGO IL US 003257 ****
,6.41,,,2020-03-02,CULVERS OF 6 COR POS CHICAGO IL US 007717 ****
,5.53,,,2020-02-29,SQ *HONEY BUTTER POS CHICAGO IL US 064405 ****
,14.95,,,2020-02-29,SQ *HONEY BUTTER POS CHICAGO IL US 048086 ****
,110.14,,,2020-02-29,FIRST ASCENT CLI POS CHICAGO IL US 010742 ****
,,150.00,,2020-02-28,INTERNET TFR FRM CHK XXXX
,15.00,,,2020-02-28,VENMO* POS Visa Direct NY US 641299 ****
,5.50,,,2020-02-27,FIRST ASCENT CLI POS CHICAGO IL US 005721 ****
,20.53,,,2020-02-26,JIMMY JOHNS - 56 POS 773-625-2551 IL US 043472 ****
,100.00,,,2020-02-24,INTERNET TFR TO CHK XXXX
,19.00,,,2020-02-24,UBER EATS POS HELP.UBER.COM CA US 076937 ****
,7.00,,,2020-02-24,VENMO* POS Visa Direct NY US 491040 ****
,,140.00,,2020-02-22,INTERNET TFR FRM CHK XXXX
,24.00,,,2020-02-22,FIRST ASCENT CLI POS CHICAGO IL US 024525 ****
,14.73,,,2020-02-22,SHAKE SHACK 1135 POS CHICAGO IL US 095303 ****
,35.00,,,2020-02-20,VENMO* POS Visa Direct NY US 444286 ****
,,99.00,,2020-02-17,SKILLSHARE POS 202-996-8412 NY US 022982 ****
,,20.00,,2020-02-17,WPY*Ferret Surge POS 866-819-1294 CA US 019063 ****
,1.68,,,2020-02-17,DUNKIN #350753 POS CHICAGO IL US 063355 ****
,14.01,,,2020-02-17,INSOMNIA COOKIES POS CHICAGO IL US 012882 ****
,11.00,,,2020-02-17,FIRST ASCENT CLI POS CHICAGO IL US 067894 ****
,5.50,,,2020-02-17,FIRST ASCENT CLI POS CHICAGO IL US 096450 ****
,99.00,,,2020-02-15,SKILLSHARE POS HTTPSWWW.SKIL NY US 025963 ****
,12.14,,,2020-02-15,JIMMY JOHNS - 56 POS 773-625-2551 IL US 059919 ****
,1.35,,,2020-02-13,NAYAX VENDING 15 POS HUNT VALLEY MD US 029014 ****
,1.00,,,2020-02-12,2689PEPSIVEN9147 POS ELK GROVE VIL IL US 030180 ****
,,125.00,,2020-02-11,INTERNET TFR FRM CHK XXXX
,15.00,,,2020-02-10,ZEL*JULIAN VALTI POS Visa Direct AZ US 318556 ****
,,15.00,,2020-02-04,ZEL*BRIAN L LENSEGRAV POS Visa Direct AZ US 339279 ****
,1.35,,,2020-02-04,NAYAX VENDING 15 POS HUNT VALLEY MD US 034469 ****
,9.49,,,2020-02-03,Wow Bao POS Chicago IL US 033058 ****
,9.49,,,2020-02-03,Wow Bao POS Chicago IL US 048083 ****
,11.04,,,2020-02-01,STANS DONUTS MIL POS CHICAGO IL US 086099 ****
,,19.75,,2020-01-31,Dougherty Mike POS New York City NY US 786540 ****
,1.53,,,2020-01-31,WALGREENS STORE POS CHICAGO IL US 815360 ****
,10.00,,,2020-01-30,VENMO* POS Visa Direct NY US 290994 ****
,,25.00,,2020-01-30,INTERNET TFR FRM CHK XXXX
,1.35,,,2020-01-22,NAYAX VENDING 15 POS HUNT VALLEY MD US 031568 ****
,,10.00,,2020-01-16,INTERNET TFR FRM CHK XXXX
,10.00,,,2020-01-16,VENMO* POS Visa Direct NY US 607080 ****
,12.23,,,2020-01-11,JIMMY JOHNS - 56 POS 773-625-2551 IL US 023580 ****
,,20.00,,2020-01-10,INTERNET TFR FRM CHK XXXX
,20.00,,,2020-01-10,JMC FOOD MART POS CHICAGO IL US 000613 ****
,,15.00,,2020-01-09,INTERNET TFR FRM CHK XXXX
,4.62,,,2020-01-09,MCDONALD'S F83 POS HARWOOD HEIGH IL US 064349 ****
,15.00,,,2020-01-06,JIMMY JOHNS - 56 POS 773-625-2551 IL US 016649 ****
,1.35,,,2020-01-03,NAYAX VENDING 15 POS HUNT VALLEY MD US 011580 ****
,8.60,,,2020-01-03,RAISING CANE'S # POS HARWOOD HEIGH IL US 052712 ****
,,25.00,,2020-01-02,INTERNET TFR FRM CHK XXXX
,35.00,,,2020-01-02,BROOKLYN BOULDER POS CHICAGO IL US 037654 ****
,6.15,,,2020-01-02,BROOKLYN BOULDER POS CHICAGO IL US 003390 ****
,,30.00,,2019-12-31,INTERNET TFR FRM CHK XXXX
,,14.75,,2019-12-30,Dougherty Mike POS New York City NY US 657665 ****
,5.57,,,2019-12-30,TST* FIRECAKES - POS CHICAGO IL US 081819 ****
,,15.00,,2019-12-28,INTERNET TFR FRM CHK XXXX
,55.00,,,2019-12-28,ZEL*JULIAN VALTI POS Visa Direct AZ US 783617 ****
,,40.00,,2019-12-23,INTERNET TFR FRM CHK XXXX
,2.10,,,2019-12-23,VENDING LEANGREE POS CHICAGO IL US 062425 ****
,6.99,,,2019-12-11,"Name.com, Inc POS 720-2492374 CO US 052483 ****"
,,15.00,,2019-12-09,INTERNET TFR FRM CHK XXXX
,9.00,,,2019-12-09,VENMO* POS Visa Direct NY US 624565 ****
,15.00,,,2019-12-09,BROOKLYN BOULDER POS CHICAGO IL US 012830 ****
,6.78,,,2019-12-09,BROOKLYN BOULDER POS CHICAGO IL US 084522 ****
,12.76,,,2019-12-07,JIMMY JOHNS - 56 POS 773-625-2551 IL US 050745 ****
,5.73,,,2019-12-07,STARBUCKS STORE POS HARWOOD HEIGH IL US 073065 ****
,8.60,,,2019-12-07,RAISING CANE'S # POS HARWOOD HEIGH IL US 030043 ****
,,20.00,,2019-12-06,INTERNET TFR FRM CHK XXXX
,,20.00,,2019-12-06,INTERNET TFR FRM CHK XXXX
,8.14,,,2019-12-06,PORTILLOS HOT DO POS HARWOOD HTS. IL US 000696 ****
,7.25,,,2019-12-06,PORTILLOS HOT DO POS HARWOOD HTS. IL US 000755 ****
,,28.00,,2019-12-04,INTERNET TFR FRM CHK XXXX
,,31.00,,2019-11-29,INTERNET TFR FRM CHK XXXX
,,5.00,,2019-11-29,INTERNET TFR FRM CHK XXXX
,35.24,,,2019-11-29,TARGET T-1888 POS Norridge IL US 161301 ****
,1.35,,,2019-11-27,NAYAX VENDING 15 POS HUNT VALLEY MD US 027656 ****
,,5.00,,2019-11-26,INTERNET TFR FRM CHK XXXX
,,10.00,,2019-11-25,INTERNET TFR FRM CHK XXXX
,16.99,,,2019-11-25,PAYPAL *EBAY COR POS 402-935-7733 CA US 072141 ****
,1.35,,,2019-11-25,NAYAX VENDING 15 POS HUNT VALLEY MD US 039221 ****
,16.00,,,2019-11-25,VENMO* POS Visa Direct NY US 369978 ****
,,25.00,,2019-11-23,INTERNET TFR FRM CHK XXXX
,20.00,,,2019-11-22,WPY*Ferret Surge POS 866-819-1294 CA US 083870 ****
,,10.00,,2019-11-21,INTERNET TFR FRM CHK XXXX
,4.91,,,2019-11-21,SUBWAY 00 POS CHICAGO IL US 065144 ****
,5.00,,,2019-11-14,VENMO* POS Visa Direct NY US 654951 ****
,5.00,,,2019-11-14,VENMO* POS Visa Direct NY US 119164 ****
,10.00,,,2019-11-14,ZEL*JULIAN VALTI POS Visa Direct AZ US 797946 ****
,9.00,,,2019-11-11,ZEL*JULIAN VALTI POS Visa Direct AZ US 796487 ****
,23.69,,,2019-11-11,SKY HIGH SPORTS POS NILES IL US 069514 ****
,,35.00,,2019-11-09,INTERNET TFR FRM CHK XXXX
,,40.00,,2019-11-08,INTERNET TFR FRM CHK XXXX
,,10.00,,2019-11-08,INTERNET TFR FRM CHK XXXX
,20.00,,,2019-11-08,6424 HOWARD STREET ATM NILES IL US 000805 ****
,2.25,,,2019-11-08,TERMINAL SURCHARGE
,13.95,,,2019-11-04,AMAZON.COM*MX310 POS SEATTLE WA US 457659 ****
,10.50,,,2019-11-04,2UC CONCESSION18 POS CHICAGO IL US 020661 ****
,14.44,,,2019-11-04,AMAZON.COM*OX4XM POS SEATTLE WA US 001295 ****
,5.99,,,2019-11-04,UBER TRIP POS HELP.UBER.COM CA US 010343 ****
,100.00,,,2019-11-01,INTERNET TFR TO CHK XXXX
,25.00,,,2019-11-01,VENMO* POS Visa Direct NY US 390433 ****
,,150.00,,2019-10-31,"Goldman Sachs Ba P2P WEB Dougherty,Kathl"
,3.04,,,2019-10-30,STARBUCKS STORE POS CHICAGO IL US 027063 ****
,2.28,,,2019-10-29,RAISING CANE'S # POS HARWOOD HEIGH IL US 066019 ****
,7.49,,,2019-10-29,RAISING CANE'S # POS HARWOOD HEIGH IL US 066017 ****
,10.58,,,2019-10-28,STANS DONUTS POS CHICAGO IL US 030265 ****
,,40.00,,2019-10-26,INTERNET TFR FRM CHK XXXX
,,50.00,,2019-10-24,INTERNET TFR FRM CHK XXXX
,2.70,,,2019-10-24,TST* SMOQUE BBQ POS CHICAGO IL US 055022 ****
,10.97,,,2019-10-24,TST* SMOQUE BBQ POS CHICAGO IL US 055014 ****
,19.90,,,2019-10-24,TST* SMOQUE BBQ POS CHICAGO IL US 055030 ****
,45.00,,,2019-10-24,ZEL*JULIAN VALTI POS Visa Direct AZ US 110076 ****
,40.00,,,2019-10-22,INTERNET TFR TO CHK XXXX
,6.80,,,2019-10-22,INSOMNIA COOKIES POS CHICAGO IL US 009071 ****
,2.04,,,2019-10-22,INSOMNIA COOKIES POS CHICAGO IL US 009089 ****
,13.20,,,2019-10-22,SMALL CHEVAL POS CHICAGO IL US 090215 ****
,16.58,,,2019-10-18,SQ *HONEY BUTTER POS CHICAGO IL US 031391 ****
,2.20,,,2019-10-18,SQ *HONEY BUTTER POS CHICAGO IL US 056222 ****
,9.50,,,2019-10-18,TST* IGNITE GAMI POS CHICAGO IL US 053946 ****
,22.32,,,2019-10-18,TST* JENI S SPLE POS CHICAGO IL US 053953 ****
,6.65,,,2019-10-18,TST* JENI S SPLE POS CHICAGO IL US 053961 ****
,22.19,,,2019-10-16,DOORDASH*WENDYS POS WWW.DOORDASH. CA US 091264 ****
,16.00,,,2019-10-16,ARCLIGHT CHICAGO POS CHICAGO IL US 048622 ****
,9.58,,,2019-10-14,POPEYES 13057 POS CHICAGO IL US 001729 ****
,,149.69,,2019-10-12,DEPOSIT FOSTER OFFICE
,,25.00,,2019-10-12,INTERNET TFR FRM CHK XXXX
,14.15,,,2019-10-11,NANDO S PERI PER POS CHICAGO IL US 065272 ****
,1.75,,,2019-10-11,LIM*RIDE COST POS XXXX CA US 045174 ****
,5.30,,,2019-10-11,ARCLIGHT CHICAGO POS CHICAGO IL US 009371 ****
,,30.00,,2019-10-10,INTERNET TFR FRM CHK XXXX
,100.00,,,2019-10-10,GOLDMAN SACHS BA COLLECTION WEB
,100.00,,,2019-10-08,INTERNET TFR TO CHK XXXX
,30.00,,,2019-10-07,VENMO* POS Visa Direct NY US 510922 ****
,4.57,,,2019-10-05,DD/BR #304935 Q3 POS CHICAGO IL US 052900 ****
,1.35,,,2019-10-04,NAYAX VENDING 15 POS HUNT VALLEY MD US 033860 ****
,1.35,,,2019-10-04,NAYAX VENDING 15 POS HUNT VALLEY MD US 030937 ****
,8.80,,,2019-10-04,TARGET T-0928 POS Niles IL US 163594 ****
,149.69,,,2019-09-26,DEPOSITED ITEM RETURNED
,10.00,,,2019-09-26,DEPOSIT ITEM RETURNED FEE
,21.99,,,2019-09-24,RS*NAME.COM POS 720-2492374 WA US 016795 ****
,,149.69,,2019-09-21,DEPOSIT FOSTER OFFICE
,,300.00,,2019-09-21,INTERNET TFR FRM CHK XXXX
,2.92,,,2019-09-21,DUNKIN #342335 Q POS CHICAGO IL US 096439 ****
,9.61,,,2019-09-21,SUBWAY 00 POS CHICAGO IL US 012028 ****
,7.18,,,2019-09-21,SUBWAY 00 POS CHICAGO IL US 099899 ****
,1.52,,,2019-09-21,JEWEL OSCO 1296 POS CHICAGO IL US 291814 ****
,,25.00,,2019-09-20,INTERNET TFR FRM CHK XXXX
,1.35,,,2019-09-20,NAYAX VENDING 15 POS HUNT VALLEY MD US 024456 ****
,1.35,,,2019-09-20,NAYAX VENDING 15 POS HUNT VALLEY MD US 024457 ****
,100.00,,,2019-09-20,GOLDMAN SACHS BA COLLECTION WEB
,30.00,,,2019-09-19,VENMO* POS Visa Direct NY US 337288 ****
,,105.25,,2019-09-18,INTERNET TFR FRM SAV XXXX
,,0.05,,2019-09-17,GOLDMAN SACHS BA PAYMENT PPD
,,0.20,,2019-09-17,GOLDMAN SACHS BA PAYMENT PPD
,46.64,,,2019-09-16,TST* SMOQUE BBQ POS CHICAGO IL US 034577 ****
,100.00,,,2019-09-16,INTERNET TFR TO CHK XXXX
,,40.59,,2019-09-16,Dougherty Mike POS New York City NY US 670692 ****
